,sub_num,vid_str,wed_num,onsetTR,state,len_TRs,offsetTR,wed_id,wed_schema
0,3,vid1a_q,0,12,1b,17,29,20,S
1,3,vid1b_q,0,29,1b,6,35,20,S
2,3,vid2_q,0,35,2b,11,46,20,S
3,3,vid3_q,0,49,3a,15,64,20,S
4,3,vid4_q,0,67,4b,16,83,20,S
5,3,vid5_q,0,83,5,7,90,20,S
6,3,vid1a,1,111,1b,17,128,23,N
7,3,vid1b,1,128,1b,6,134,23,N
8,3,vid2,1,134,2a,11,145,23,N
9,3,vid3,1,145,3a,15,160,23,N
10,3,vid4,1,160,4a,16,176,23,N
11,3,vid5,1,176,5,7,183,23,N
12,3,vid1a,2,207,1b,17,224,6,N
13,3,vid1b,2,224,1b,6,230,6,N
14,3,vid2,2,230,2a,11,241,6,N
15,3,vid3,2,241,3a,15,256,6,N
16,3,vid4,2,257,4a,16,273,6,N
17,3,vid5,2,273,5,7,280,6,N
18,3,vid1a,3,303,1b,17,320,17,S
19,3,vid1b,3,320,1b,6,326,17,S
20,3,vid2,3,326,2b,11,337,17,S
21,3,vid3,3,337,3a,15,352,17,S
22,3,vid4,3,353,4b,16,369,17,S
23,3,vid5,3,369,5,7,376,17,S
24,3,vid1a,4,399,1b,17,416,38,S
25,3,vid1b,4,416,1b,6,422,38,S
26,3,vid2,4,422,2b,11,433,38,S
27,3,vid3,4,433,3a,15,448,38,S
28,3,vid4,4,449,4b,16,465,38,S
29,3,vid5,4,465,5,7,472,38,S
30,3,vid1a,5,495,1b,17,512,22,N
31,3,vid1b,5,512,1b,6,518,22,N
32,3,vid2,5,518,2b,11,529,22,N
33,3,vid3,5,529,3b,15,544,22,N
34,3,vid4,5,545,4b,16,561,22,N
35,3,vid5,5,561,5,7,568,22,N
36,3,vid1a,6,591,1b,17,608,34,N
37,3,vid1b,6,608,1b,6,614,34,N
38,3,vid2,6,614,2b,11,625,34,N
39,3,vid3,6,625,3b,15,640,34,N
40,3,vid4,6,641,4b,16,657,34,N
41,3,vid5,6,657,5,7,664,34,N
42,3,vid1a,7,687,1b,17,704,2,S
43,3,vid1b,7,704,1b,6,710,2,S
44,3,vid2,7,710,2a,11,721,2,S
45,3,vid3,7,721,3b,15,736,2,S
46,3,vid4,7,737,4a,16,753,2,S
47,3,vid5,7,753,5,7,760,2,S
48,3,vid1a,8,784,1b,17,801,29,S
49,3,vid1b,8,800,1b,6,806,29,S
50,3,vid2,8,806,2a,11,817,29,S
51,3,vid3,8,818,3b,15,833,29,S
52,3,vid4,8,833,4a,16,849,29,S
53,3,vid5,8,849,5,7,856,29,S
54,3,vid1a,9,880,1b,17,897,1,N
55,3,vid1b,9,896,1b,6,902,1,N
56,3,vid2,9,902,2b,11,913,1,N
57,3,vid3,9,914,3b,15,929,1,N
58,3,vid4,9,929,4b,16,945,1,N
59,3,vid5,9,945,5,7,952,1,N
60,3,vid1a,10,976,1b,17,993,19,N
61,3,vid1b,10,993,1b,6,999,19,N
62,3,vid2,10,999,2a,11,1010,19,N
63,3,vid3,10,1010,3a,15,1025,19,N
64,3,vid4,10,1025,4a,16,1041,19,N
65,3,vid5,10,1041,5,7,1048,19,N
66,3,vid1a_q,11,1075,1b,17,1092,28,S
67,3,vid1b_q,11,1092,1b,6,1098,28,S
68,3,vid2_q,11,1098,2a,11,1109,28,S
69,3,vid3_q,11,1112,3b,15,1127,28,S
70,3,vid4_q,11,1130,4a,16,1146,28,S
71,3,vid5_q,11,1146,5,7,1153,28,S
72,4,vid1a_q,0,12,1b,17,29,23,S
73,4,vid1b_q,0,29,1b,6,35,23,S
74,4,vid2_q,0,35,2a,11,46,23,S
75,4,vid3_q,0,49,3b,15,64,23,S
76,4,vid4_q,0,67,4a,16,83,23,S
77,4,vid5_q,0,83,5,7,90,23,S
78,4,vid1a,1,112,1b,17,129,29,N
79,4,vid1b,1,128,1b,6,134,29,N
80,4,vid2,1,134,2b,11,145,29,N
81,4,vid3,1,146,3b,15,161,29,N
82,4,vid4,1,161,4b,16,177,29,N
83,4,vid5,1,177,5,7,184,29,N
84,4,vid1a,2,207,1b,17,224,6,N
85,4,vid1b,2,224,1b,6,230,6,N
86,4,vid2,2,230,2a,11,241,6,N
87,4,vid3,2,241,3a,15,256,6,N
88,4,vid4,2,257,4a,16,273,6,N
89,4,vid5,2,273,5,7,280,6,N
90,4,vid1a,3,303,1b,17,320,28,S
91,4,vid1b,3,320,1b,6,326,28,S
92,4,vid2,3,326,2b,11,337,28,S
93,4,vid3,3,337,3a,15,352,28,S
94,4,vid4,3,352,4b,16,368,28,S
95,4,vid5,3,368,5,7,375,28,S
96,4,vid1a,4,399,1b,17,416,19,S
97,4,vid1b,4,416,1b,6,422,19,S
98,4,vid2,4,422,2b,11,433,19,S
99,4,vid3,4,433,3a,15,448,19,S
100,4,vid4,4,449,4b,16,465,19,S
101,4,vid5,4,465,5,7,472,19,S
102,4,vid1a,5,495,1b,17,512,1,N
103,4,vid1b,5,512,1b,6,518,1,N
104,4,vid2,5,518,2b,11,529,1,N
105,4,vid3,5,530,3b,15,545,1,N
106,4,vid4,5,545,4b,16,561,1,N
107,4,vid5,5,561,5,7,568,1,N
108,4,vid1a,6,592,1b,17,609,34,N
109,4,vid1b,6,608,1b,6,614,34,N
110,4,vid2,6,614,2b,11,625,34,N
111,4,vid3,6,626,3b,15,641,34,N
112,4,vid4,6,641,4b,16,657,34,N
113,4,vid5,6,657,5,7,664,34,N
114,4,vid1a,7,687,1b,17,704,20,S
115,4,vid1b,7,704,1b,6,710,20,S
116,4,vid2,7,710,2a,11,721,20,S
117,4,vid3,7,722,3b,15,737,20,S
118,4,vid4,7,737,4a,16,753,20,S
119,4,vid5,7,753,5,7,760,20,S
120,4,vid1a,8,783,1b,17,800,17,S
121,4,vid1b,8,800,1b,6,806,17,S
122,4,vid2,8,806,2b,11,817,17,S
123,4,vid3,8,817,3a,15,832,17,S
124,4,vid4,8,832,4b,16,848,17,S
125,4,vid5,8,848,5,7,855,17,S
126,4,vid1a,9,879,1b,17,896,22,N
127,4,vid1b,9,896,1b,6,902,22,N
128,4,vid2,9,902,2a,11,913,22,N
129,4,vid3,9,913,3a,15,928,22,N
130,4,vid4,9,929,4a,16,945,22,N
131,4,vid5,9,945,5,7,952,22,N
132,4,vid1a,10,976,1b,17,993,38,N
133,4,vid1b,10,992,1b,6,998,38,N
134,4,vid2,10,998,2a,11,1009,38,N
135,4,vid3,10,1010,3a,15,1025,38,N
136,4,vid4,10,1025,4a,16,1041,38,N
137,4,vid5,10,1041,5,7,1048,38,N
138,4,vid1a_q,11,1074,1b,17,1091,2,S
139,4,vid1b_q,11,1091,1b,6,1097,2,S
140,4,vid2_q,11,1097,2a,11,1108,2,S
141,4,vid3_q,11,1111,3b,15,1126,2,S
142,4,vid4_q,11,1129,4a,16,1145,2,S
143,4,vid5_q,11,1145,5,7,1152,2,S
144,5,vid1a_q,0,12,1b,17,29,23,S
145,5,vid1b_q,0,29,1b,6,35,23,S
146,5,vid2_q,0,35,2b,11,46,23,S
147,5,vid3_q,0,49,3a,15,64,23,S
148,5,vid4_q,0,67,4b,16,83,23,S
149,5,vid5_q,0,83,5,7,90,23,S
150,5,vid1a,1,112,1b,17,129,2,N
151,5,vid1b,1,128,1b,6,134,2,N
152,5,vid2,1,134,2b,11,145,2,N
153,5,vid3,1,146,3b,15,161,2,N
154,5,vid4,1,161,4b,16,177,2,N
155,5,vid5,1,177,5,7,184,2,N
156,5,vid1a,2,207,1b,17,224,28,N
157,5,vid1b,2,224,1b,6,230,28,N
158,5,vid2,2,230,2b,11,241,28,N
159,5,vid3,2,242,3b,15,257,28,N
160,5,vid4,2,257,4b,16,273,28,N
161,5,vid5,2,273,5,7,280,28,N
162,5,vid1a,3,303,1b,17,320,29,S
163,5,vid1b,3,320,1b,6,326,29,S
164,5,vid2,3,326,2b,11,337,29,S
165,5,vid3,3,338,3a,15,353,29,S
166,5,vid4,3,353,4b,16,369,29,S
167,5,vid5,3,369,5,7,376,29,S
168,5,vid1a,4,399,1b,17,416,19,S
169,5,vid1b,4,416,1b,6,422,19,S
170,5,vid2,4,422,2a,11,433,19,S
171,5,vid3,4,433,3b,15,448,19,S
172,5,vid4,4,449,4a,16,465,19,S
173,5,vid5,4,465,5,7,472,19,S
174,5,vid1a,5,496,1b,17,513,22,N
175,5,vid1b,5,512,1b,6,518,22,N
176,5,vid2,5,518,2b,11,529,22,N
177,5,vid3,5,530,3b,15,545,22,N
178,5,vid4,5,545,4b,16,561,22,N
179,5,vid5,5,561,5,7,568,22,N
180,5,vid1a,6,592,1b,17,609,34,N
181,5,vid1b,6,608,1b,6,614,34,N
182,5,vid2,6,614,2a,11,625,34,N
183,5,vid3,6,626,3a,15,641,34,N
184,5,vid4,6,641,4a,16,657,34,N
185,5,vid5,6,657,5,7,664,34,N
186,5,vid1a,7,688,1b,17,705,1,S
187,5,vid1b,7,704,1b,6,710,1,S
188,5,vid2,7,710,2b,11,721,1,S
189,5,vid3,7,722,3a,15,737,1,S
190,5,vid4,7,737,4b,16,753,1,S
191,5,vid5,7,753,5,7,760,1,S
192,5,vid1a,8,784,1b,17,801,38,S
193,5,vid1b,8,800,1b,6,806,38,S
194,5,vid2,8,806,2a,11,817,38,S
195,5,vid3,8,818,3b,15,833,38,S
196,5,vid4,8,833,4a,16,849,38,S
197,5,vid5,8,849,5,7,856,38,S
198,5,vid1a,9,880,1b,17,897,6,N
199,5,vid1b,9,897,1b,6,903,6,N
200,5,vid2,9,903,2a,11,914,6,N
201,5,vid3,9,914,3a,15,929,6,N
202,5,vid4,9,929,4a,16,945,6,N
203,5,vid5,9,945,5,7,952,6,N
204,5,vid1a,10,976,1b,17,993,20,N
205,5,vid1b,10,993,1b,6,999,20,N
206,5,vid2,10,999,2a,11,1010,20,N
207,5,vid3,10,1011,3a,15,1026,20,N
208,5,vid4,10,1026,4a,16,1042,20,N
209,5,vid5,10,1042,5,7,1049,20,N
210,5,vid1a_q,11,1074,1b,17,1091,17,S
211,5,vid1b_q,11,1091,1b,6,1097,17,S
212,5,vid2_q,11,1097,2a,11,1108,17,S
213,5,vid3_q,11,1111,3b,15,1126,17,S
214,5,vid4_q,11,1129,4a,16,1145,17,S
215,5,vid5_q,11,1145,5,7,1152,17,S
216,6,vid1a_q,0,12,1b,17,29,6,S
217,6,vid1b_q,0,29,1b,6,35,6,S
218,6,vid2_q,0,35,2b,11,46,6,S
219,6,vid3_q,0,49,3a,15,64,6,S
220,6,vid4_q,0,67,4b,16,83,6,S
221,6,vid5_q,0,83,5,7,90,6,S
222,6,vid1a,1,111,1b,17,128,38,N
223,6,vid1b,1,128,1b,6,134,38,N
224,6,vid2,1,134,2b,11,145,38,N
225,6,vid3,1,145,3b,15,160,38,N
226,6,vid4,1,161,4b,16,177,38,N
227,6,vid5,1,177,5,7,184,38,N
228,6,vid1a,2,207,1b,17,224,20,N
229,6,vid1b,2,224,1b,6,230,20,N
230,6,vid2,2,230,2b,11,241,20,N
231,6,vid3,2,241,3b,15,256,20,N
232,6,vid4,2,257,4b,16,273,20,N
233,6,vid5,2,273,5,7,280,20,N
234,6,vid1a,3,302,1b,17,319,1,S
235,6,vid1b,3,319,1b,6,325,1,S
236,6,vid2,3,325,2b,11,336,1,S
237,6,vid3,3,336,3a,15,351,1,S
238,6,vid4,3,352,4b,16,368,1,S
239,6,vid5,3,368,5,7,375,1,S
240,6,vid1a,4,398,1b,17,415,22,S
241,6,vid1b,4,415,1b,6,421,22,S
242,6,vid2,4,421,2a,11,432,22,S
243,6,vid3,4,432,3b,15,447,22,S
244,6,vid4,4,448,4a,16,464,22,S
245,6,vid5,4,464,5,7,471,22,S
246,6,vid1a,5,494,1b,17,511,19,N
247,6,vid1b,5,511,1b,6,517,19,N
248,6,vid2,5,517,2a,11,528,19,N
249,6,vid3,5,528,3a,15,543,19,N
250,6,vid4,5,544,4a,16,560,19,N
251,6,vid5,5,560,5,7,567,19,N
252,6,vid1a,6,591,1b,17,608,2,N
253,6,vid1b,6,608,1b,6,614,2,N
254,6,vid2,6,614,2b,11,625,2,N
255,6,vid3,6,625,3b,15,640,2,N
256,6,vid4,6,640,4b,16,656,2,N
257,6,vid5,6,656,5,7,663,2,N
258,6,vid1a,7,687,1b,17,704,29,S
259,6,vid1b,7,704,1b,6,710,29,S
260,6,vid2,7,710,2a,11,721,29,S
261,6,vid3,7,721,3b,15,736,29,S
262,6,vid4,7,736,4a,16,752,29,S
263,6,vid5,7,752,5,7,759,29,S
264,6,vid1a,8,783,1b,17,800,17,S
265,6,vid1b,8,800,1b,6,806,17,S
266,6,vid2,8,806,2b,11,817,17,S
267,6,vid3,8,817,3a,15,832,17,S
268,6,vid4,8,832,4b,16,848,17,S
269,6,vid5,8,848,5,7,855,17,S
270,6,vid1a,9,879,1b,17,896,28,N
271,6,vid1b,9,896,1b,6,902,28,N
272,6,vid2,9,902,2a,11,913,28,N
273,6,vid3,9,913,3a,15,928,28,N
274,6,vid4,9,929,4a,16,945,28,N
275,6,vid5,9,945,5,7,952,28,N
276,6,vid1a,10,976,1b,17,993,23,N
277,6,vid1b,10,993,1b,6,999,23,N
278,6,vid2,10,999,2a,11,1010,23,N
279,6,vid3,10,1010,3a,15,1025,23,N
280,6,vid4,10,1025,4a,16,1041,23,N
281,6,vid5,10,1041,5,7,1048,23,N
282,6,vid1a_q,11,1075,1b,17,1092,34,S
283,6,vid1b_q,11,1092,1b,6,1098,34,S
284,6,vid2_q,11,1098,2a,11,1109,34,S
285,6,vid3_q,11,1112,3b,15,1127,34,S
286,6,vid4_q,11,1130,4a,16,1146,34,S
287,6,vid5_q,11,1146,5,7,1153,34,S
288,7,vid1a_q,0,13,1b,17,30,23,S
289,7,vid1b_q,0,29,1b,6,35,23,S
290,7,vid2_q,0,35,2a,11,46,23,S
291,7,vid3_q,0,49,3b,15,64,23,S
292,7,vid4_q,0,67,4a,16,83,23,S
293,7,vid5_q,0,83,5,7,90,23,S
294,7,vid1a,1,112,1b,17,129,1,N
295,7,vid1b,1,129,1b,6,135,1,N
296,7,vid2,1,135,2b,11,146,1,N
297,7,vid3,1,146,3b,15,161,1,N
298,7,vid4,1,162,4b,16,178,1,N
299,7,vid5,1,178,5,7,185,1,N
300,7,vid1a,2,208,1b,17,225,22,N
301,7,vid1b,2,225,1b,6,231,22,N
302,7,vid2,2,231,2a,11,242,22,N
303,7,vid3,2,242,3a,15,257,22,N
304,7,vid4,2,257,4a,16,273,22,N
305,7,vid5,2,273,5,7,280,22,N
306,7,vid1a,3,304,1b,17,321,19,S
307,7,vid1b,3,320,1b,6,326,19,S
308,7,vid2,3,326,2a,11,337,19,S
309,7,vid3,3,338,3b,15,353,19,S
310,7,vid4,3,353,4a,16,369,19,S
311,7,vid5,3,369,5,7,376,19,S
312,7,vid1a,4,400,1b,17,417,20,S
313,7,vid1b,4,417,1b,6,423,20,S
314,7,vid2,4,423,2b,11,434,20,S
315,7,vid3,4,434,3a,15,449,20,S
316,7,vid4,4,449,4b,16,465,20,S
317,7,vid5,4,465,5,7,472,20,S
318,7,vid1a,5,495,1b,17,512,2,N
319,7,vid1b,5,512,1b,6,518,2,N
320,7,vid2,5,518,2a,11,529,2,N
321,7,vid3,5,529,3a,15,544,2,N
322,7,vid4,5,545,4a,16,561,2,N
323,7,vid5,5,561,5,7,568,2,N
324,7,vid1a,6,591,1b,17,608,28,N
325,7,vid1b,6,608,1b,6,614,28,N
326,7,vid2,6,614,2b,11,625,28,N
327,7,vid3,6,625,3b,15,640,28,N
328,7,vid4,6,641,4b,16,657,28,N
329,7,vid5,6,657,5,7,664,28,N
330,7,vid1a,7,688,1b,17,705,38,S
331,7,vid1b,7,705,1b,6,711,38,S
332,7,vid2,7,711,2b,11,722,38,S
333,7,vid3,7,722,3a,15,737,38,S
334,7,vid4,7,737,4b,16,753,38,S
335,7,vid5,7,753,5,7,760,38,S
336,7,vid1a,8,784,1b,17,801,29,S
337,7,vid1b,8,801,1b,6,807,29,S
338,7,vid2,8,807,2b,11,818,29,S
339,7,vid3,8,818,3a,15,833,29,S
340,7,vid4,8,833,4b,16,849,29,S
341,7,vid5,8,849,5,7,856,29,S
342,7,vid1a,9,880,1b,17,897,17,N
343,7,vid1b,9,897,1b,6,903,17,N
344,7,vid2,9,903,2b,11,914,17,N
345,7,vid3,9,914,3b,15,929,17,N
346,7,vid4,9,930,4b,16,946,17,N
347,7,vid5,9,946,5,7,953,17,N
348,7,vid1a,10,977,1b,17,994,34,N
349,7,vid1b,10,993,1b,6,999,34,N
350,7,vid2,10,999,2a,11,1010,34,N
351,7,vid3,10,1011,3a,15,1026,34,N
352,7,vid4,10,1026,4a,16,1042,34,N
353,7,vid5,10,1042,5,7,1049,34,N
354,7,vid1a_q,11,1075,1b,17,1092,6,S
355,7,vid1b_q,11,1092,1b,6,1098,6,S
356,7,vid2_q,11,1098,2a,11,1109,6,S
357,7,vid3_q,11,1112,3b,15,1127,6,S
358,7,vid4_q,11,1130,4a,16,1146,6,S
359,7,vid5_q,11,1146,5,7,1153,6,S
360,8,vid1a_q,0,12,1b,17,29,1,S
361,8,vid1b_q,0,29,1b,6,35,1,S
362,8,vid2_q,0,35,2b,11,46,1,S
363,8,vid3_q,0,49,3a,15,64,1,S
364,8,vid4_q,0,67,4b,16,83,1,S
365,8,vid5_q,0,83,5,7,90,1,S
366,8,vid1a,1,111,1b,17,128,28,N
367,8,vid1b,1,128,1b,6,134,28,N
368,8,vid2,1,134,2b,11,145,28,N
369,8,vid3,1,145,3b,15,160,28,N
370,8,vid4,1,161,4b,16,177,28,N
371,8,vid5,1,177,5,7,184,28,N
372,8,vid1a,2,207,1b,17,224,6,N
373,8,vid1b,2,224,1b,6,230,6,N
374,8,vid2,2,230,2a,11,241,6,N
375,8,vid3,2,241,3a,15,256,6,N
376,8,vid4,2,257,4a,16,273,6,N
377,8,vid5,2,273,5,7,280,6,N
378,8,vid1a,3,304,1b,17,321,34,S
379,8,vid1b,3,320,1b,6,326,34,S
380,8,vid2,3,326,2a,11,337,34,S
381,8,vid3,3,337,3b,15,352,34,S
382,8,vid4,3,353,4a,16,369,34,S
383,8,vid5,3,369,5,7,376,34,S
384,8,vid1a,4,399,1b,17,416,19,S
385,8,vid1b,4,416,1b,6,422,19,S
386,8,vid2,4,422,2b,11,433,19,S
387,8,vid3,4,433,3a,15,448,19,S
388,8,vid4,4,449,4b,16,465,19,S
389,8,vid5,4,465,5,7,472,19,S
390,8,vid1a,5,496,1b,17,513,2,N
391,8,vid1b,5,512,1b,6,518,2,N
392,8,vid2,5,518,2b,11,529,2,N
393,8,vid3,5,530,3b,15,545,2,N
394,8,vid4,5,545,4b,16,561,2,N
395,8,vid5,5,561,5,7,568,2,N
396,8,vid1a,6,592,1b,17,609,23,N
397,8,vid1b,6,609,1b,6,615,23,N
398,8,vid2,6,615,2a,11,626,23,N
399,8,vid3,6,626,3a,15,641,23,N
400,8,vid4,6,641,4a,16,657,23,N
401,8,vid5,6,657,5,7,664,23,N
402,8,vid1a,7,688,1b,17,705,17,S
403,8,vid1b,7,705,1b,6,711,17,S
404,8,vid2,7,711,2b,11,722,17,S
405,8,vid3,7,723,3a,15,738,17,S
406,8,vid4,7,738,4b,16,754,17,S
407,8,vid5,7,754,5,7,761,17,S
408,8,vid1a,8,785,1b,17,802,22,S
409,8,vid1b,8,801,1b,6,807,22,S
410,8,vid2,8,807,2a,11,818,22,S
411,8,vid3,8,819,3b,15,834,22,S
412,8,vid4,8,834,4a,16,850,22,S
413,8,vid5,8,850,5,7,857,22,S
414,8,vid1a,9,881,1b,17,898,20,N
415,8,vid1b,9,898,1b,6,904,20,N
416,8,vid2,9,904,2a,11,915,20,N
417,8,vid3,9,915,3a,15,930,20,N
418,8,vid4,9,930,4a,16,946,20,N
419,8,vid5,9,946,5,7,953,20,N
420,8,vid1a,10,977,1b,17,994,38,N
421,8,vid1b,10,993,1b,6,999,38,N
422,8,vid2,10,999,2b,11,1010,38,N
423,8,vid3,10,1011,3b,15,1026,38,N
424,8,vid4,10,1026,4b,16,1042,38,N
425,8,vid5,10,1042,5,7,1049,38,N
426,8,vid1a_q,11,1075,1b,17,1092,29,S
427,8,vid1b_q,11,1092,1b,6,1098,29,S
428,8,vid2_q,11,1098,2a,11,1109,29,S
429,8,vid3_q,11,1112,3b,15,1127,29,S
430,8,vid4_q,11,1130,4a,16,1146,29,S
431,8,vid5_q,11,1146,5,7,1153,29,S
432,9,vid1a_q,0,12,1b,17,29,6,S
433,9,vid1b_q,0,29,1b,6,35,6,S
434,9,vid2_q,0,35,2b,11,46,6,S
435,9,vid3_q,0,49,3a,15,64,6,S
436,9,vid4_q,0,67,4b,16,83,6,S
437,9,vid5_q,0,83,5,7,90,6,S
438,9,vid1a,1,112,1b,17,129,29,N
439,9,vid1b,1,128,1b,6,134,29,N
440,9,vid2,1,134,2a,11,145,29,N
441,9,vid3,1,146,3a,15,161,29,N
442,9,vid4,1,161,4a,16,177,29,N
443,9,vid5,1,177,5,7,184,29,N
444,9,vid1a,2,207,1b,17,224,1,N
445,9,vid1b,2,224,1b,6,230,1,N
446,9,vid2,2,230,2b,11,241,1,N
447,9,vid3,2,241,3b,15,256,1,N
448,9,vid4,2,257,4b,16,273,1,N
449,9,vid5,2,273,5,7,280,1,N
450,9,vid1a,3,303,1b,17,320,22,S
451,9,vid1b,3,320,1b,6,326,22,S
452,9,vid2,3,326,2a,11,337,22,S
453,9,vid3,3,337,3b,15,352,22,S
454,9,vid4,3,353,4a,16,369,22,S
455,9,vid5,3,369,5,7,376,22,S
456,9,vid1a,4,399,1b,17,416,34,S
457,9,vid1b,4,416,1b,6,422,34,S
458,9,vid2,4,422,2a,11,433,34,S
459,9,vid3,4,433,3b,15,448,34,S
460,9,vid4,4,449,4a,16,465,34,S
461,9,vid5,4,465,5,7,472,34,S
462,9,vid1a,5,495,1b,17,512,19,N
463,9,vid1b,5,512,1b,6,518,19,N
464,9,vid2,5,518,2b,11,529,19,N
465,9,vid3,5,529,3b,15,544,19,N
466,9,vid4,5,544,4b,16,560,19,N
467,9,vid5,5,560,5,7,567,19,N
468,9,vid1a,6,592,1b,17,609,17,N
469,9,vid1b,6,608,1b,6,614,17,N
470,9,vid2,6,614,2a,11,625,17,N
471,9,vid3,6,626,3a,15,641,17,N
472,9,vid4,6,641,4a,16,657,17,N
473,9,vid5,6,657,5,7,664,17,N
474,9,vid1a,7,688,1b,17,705,23,S
475,9,vid1b,7,704,1b,6,710,23,S
476,9,vid2,7,710,2b,11,721,23,S
477,9,vid3,7,722,3a,15,737,23,S
478,9,vid4,7,737,4b,16,753,23,S
479,9,vid5,7,753,5,7,760,23,S
480,9,vid1a,8,784,1b,17,801,20,S
481,9,vid1b,8,801,1b,6,807,20,S
482,9,vid2,8,807,2b,11,818,20,S
483,9,vid3,8,818,3a,15,833,20,S
484,9,vid4,8,834,4b,16,850,20,S
485,9,vid5,8,850,5,7,857,20,S
486,9,vid1a,9,880,1b,17,897,28,N
487,9,vid1b,9,897,1b,6,903,28,N
488,9,vid2,9,903,2a,11,914,28,N
489,9,vid3,9,914,3a,15,929,28,N
490,9,vid4,9,929,4a,16,945,28,N
491,9,vid5,9,945,5,7,952,28,N
492,9,vid1a,10,977,1b,17,994,2,N
493,9,vid1b,10,993,1b,6,999,2,N
494,9,vid2,10,999,2b,11,1010,2,N
495,9,vid3,10,1011,3b,15,1026,2,N
496,9,vid4,10,1026,4b,16,1042,2,N
497,9,vid5,10,1042,5,7,1049,2,N
498,9,vid1a_q,11,1075,1b,17,1092,38,S
499,9,vid1b_q,11,1092,1b,6,1098,38,S
500,9,vid2_q,11,1098,2a,11,1109,38,S
501,9,vid3_q,11,1112,3b,15,1127,38,S
502,9,vid4_q,11,1130,4a,16,1146,38,S
503,9,vid5_q,11,1146,5,7,1153,38,S
504,10,vid1a_q,0,12,1b,17,29,17,S
505,10,vid1b_q,0,29,1b,6,35,17,S
506,10,vid2_q,0,35,2b,11,46,17,S
507,10,vid3_q,0,49,3a,15,64,17,S
508,10,vid4_q,0,67,4b,16,83,17,S
509,10,vid5_q,0,83,5,7,90,17,S
510,10,vid1a,1,112,1b,17,129,2,N
511,10,vid1b,1,128,1b,6,134,2,N
512,10,vid2,1,134,2b,11,145,2,N
513,10,vid3,1,146,3b,15,161,2,N
514,10,vid4,1,161,4b,16,177,2,N
515,10,vid5,1,177,5,7,184,2,N
516,10,vid1a,2,208,1b,17,225,19,N
517,10,vid1b,2,224,1b,6,230,19,N
518,10,vid2,2,230,2a,11,241,19,N
519,10,vid3,2,242,3a,15,257,19,N
520,10,vid4,2,257,4a,16,273,19,N
521,10,vid5,2,273,5,7,280,19,N
522,10,vid1a,3,304,1b,17,321,34,S
523,10,vid1b,3,320,1b,6,326,34,S
524,10,vid2,3,326,2a,11,337,34,S
525,10,vid3,3,338,3b,15,353,34,S
526,10,vid4,3,353,4a,16,369,34,S
527,10,vid5,3,369,5,7,376,34,S
528,10,vid1a,4,399,1b,17,416,28,S
529,10,vid1b,4,416,1b,6,422,28,S
530,10,vid2,4,422,2b,11,433,28,S
531,10,vid3,4,434,3a,15,449,28,S
532,10,vid4,4,449,4b,16,465,28,S
533,10,vid5,4,465,5,7,472,28,S
534,10,vid1a,5,496,1b,17,513,6,N
535,10,vid1b,5,512,1b,6,518,6,N
536,10,vid2,5,518,2b,11,529,6,N
537,10,vid3,5,530,3b,15,545,6,N
538,10,vid4,5,545,4b,16,561,6,N
539,10,vid5,5,561,5,7,568,6,N
540,10,vid1a,6,592,1b,17,609,20,N
541,10,vid1b,6,609,1b,6,615,20,N
542,10,vid2,6,615,2b,11,626,20,N
543,10,vid3,6,626,3b,15,641,20,N
544,10,vid4,6,641,4b,16,657,20,N
545,10,vid5,6,657,5,7,664,20,N
546,10,vid1a,7,687,1b,17,704,1,S
547,10,vid1b,7,704,1b,6,710,1,S
548,10,vid2,7,710,2a,11,721,1,S
549,10,vid3,7,721,3b,15,736,1,S
550,10,vid4,7,737,4a,16,753,1,S
551,10,vid5,7,753,5,7,760,1,S
552,10,vid1a,8,783,1b,17,800,29,S
553,10,vid1b,8,800,1b,6,806,29,S
554,10,vid2,8,806,2b,11,817,29,S
555,10,vid3,8,817,3a,15,832,29,S
556,10,vid4,8,833,4b,16,849,29,S
557,10,vid5,8,849,5,7,856,29,S
558,10,vid1a,9,880,1b,17,897,23,N
559,10,vid1b,9,896,1b,6,902,23,N
560,10,vid2,9,902,2a,11,913,23,N
561,10,vid3,9,914,3a,15,929,23,N
562,10,vid4,9,929,4a,16,945,23,N
563,10,vid5,9,945,5,7,952,23,N
564,10,vid1a,10,976,1b,17,993,22,N
565,10,vid1b,10,993,1b,6,999,22,N
566,10,vid2,10,999,2a,11,1010,22,N
567,10,vid3,10,1010,3a,15,1025,22,N
568,10,vid4,10,1026,4a,16,1042,22,N
569,10,vid5,10,1042,5,7,1049,22,N
570,10,vid1a_q,11,1075,1b,17,1092,38,S
571,10,vid1b_q,11,1092,1b,6,1098,38,S
572,10,vid2_q,11,1098,2a,11,1109,38,S
573,10,vid3_q,11,1112,3b,15,1127,38,S
574,10,vid4_q,11,1130,4a,16,1146,38,S
575,10,vid5_q,11,1146,5,7,1153,38,S
576,11,vid1a_q,0,12,1b,17,29,34,S
577,11,vid1b_q,0,29,1b,6,35,34,S
578,11,vid2_q,0,35,2b,11,46,34,S
579,11,vid3_q,0,49,3a,15,64,34,S
580,11,vid4_q,0,67,4b,16,83,34,S
581,11,vid5_q,0,83,5,7,90,34,S
582,11,vid1a,1,111,1b,17,128,23,N
583,11,vid1b,1,128,1b,6,134,23,N
584,11,vid2,1,134,2b,11,145,23,N
585,11,vid3,1,145,3b,15,160,23,N
586,11,vid4,1,161,4b,16,177,23,N
587,11,vid5,1,177,5,7,184,23,N
588,11,vid1a,2,207,1b,17,224,28,N
589,11,vid1b,2,224,1b,6,230,28,N
590,11,vid2,2,230,2a,11,241,28,N
591,11,vid3,2,241,3a,15,256,28,N
592,11,vid4,2,257,4a,16,273,28,N
593,11,vid5,2,273,5,7,280,28,N
594,11,vid1a,3,304,1b,17,321,19,S
595,11,vid1b,3,320,1b,6,326,19,S
596,11,vid2,3,326,2a,11,337,19,S
597,11,vid3,3,338,3b,15,353,19,S
598,11,vid4,3,353,4a,16,369,19,S
599,11,vid5,3,369,5,7,376,19,S
600,11,vid1a,4,400,1b,17,417,29,S
601,11,vid1b,4,417,1b,6,423,29,S
602,11,vid2,4,423,2a,11,434,29,S
603,11,vid3,4,434,3b,15,449,29,S
604,11,vid4,4,449,4a,16,465,29,S
605,11,vid5,4,465,5,7,472,29,S
606,11,vid1a,5,496,1b,17,513,6,N
607,11,vid1b,5,512,1b,6,518,6,N
608,11,vid2,5,518,2a,11,529,6,N
609,11,vid3,5,530,3a,15,545,6,N
610,11,vid4,5,545,4a,16,561,6,N
611,11,vid5,5,561,5,7,568,6,N
612,11,vid1a,6,592,1b,17,609,38,N
613,11,vid1b,6,609,1b,6,615,38,N
614,11,vid2,6,615,2a,11,626,38,N
615,11,vid3,6,626,3a,15,641,38,N
616,11,vid4,6,641,4a,16,657,38,N
617,11,vid5,6,657,5,7,664,38,N
618,11,vid1a,7,688,1b,17,705,2,S
619,11,vid1b,7,705,1b,6,711,2,S
620,11,vid2,7,711,2a,11,722,2,S
621,11,vid3,7,722,3b,15,737,2,S
622,11,vid4,7,738,4a,16,754,2,S
623,11,vid5,7,754,5,7,761,2,S
624,11,vid1a,8,784,1b,17,801,17,S
625,11,vid1b,8,801,1b,6,807,17,S
626,11,vid2,8,807,2b,11,818,17,S
627,11,vid3,8,818,3a,15,833,17,S
628,11,vid4,8,834,4b,16,850,17,S
629,11,vid5,8,850,5,7,857,17,S
630,11,vid1a,9,881,1b,17,898,22,N
631,11,vid1b,9,897,1b,6,903,22,N
632,11,vid2,9,903,2b,11,914,22,N
633,11,vid3,9,915,3b,15,930,22,N
634,11,vid4,9,930,4b,16,946,22,N
635,11,vid5,9,946,5,7,953,22,N
636,11,vid1a,10,977,1b,17,994,1,N
637,11,vid1b,10,994,1b,6,1000,1,N
638,11,vid2,10,1000,2b,11,1011,1,N
639,11,vid3,10,1011,3b,15,1026,1,N
640,11,vid4,10,1026,4b,16,1042,1,N
641,11,vid5,10,1042,5,7,1049,1,N
642,11,vid1a_q,11,1075,1b,17,1092,20,S
643,11,vid1b_q,11,1092,1b,6,1098,20,S
644,11,vid2_q,11,1098,2b,11,1109,20,S
645,11,vid3_q,11,1112,3a,15,1127,20,S
646,11,vid4_q,11,1130,4b,16,1146,20,S
647,11,vid5_q,11,1146,5,7,1153,20,S
648,12,vid1a_q,0,12,1b,17,29,34,S
649,12,vid1b_q,0,29,1b,6,35,34,S
650,12,vid2_q,0,35,2a,11,46,34,S
651,12,vid3_q,0,49,3b,15,64,34,S
652,12,vid4_q,0,67,4a,16,83,34,S
653,12,vid5_q,0,83,5,7,90,34,S
654,12,vid1a,1,111,1b,17,128,17,N
655,12,vid1b,1,128,1b,6,134,17,N
656,12,vid2,1,134,2a,11,145,17,N
657,12,vid3,1,145,3a,15,160,17,N
658,12,vid4,1,161,4a,16,177,17,N
659,12,vid5,1,177,5,7,184,17,N
660,12,vid1a,2,207,1b,17,224,6,N
661,12,vid1b,2,224,1b,6,230,6,N
662,12,vid2,2,230,2a,11,241,6,N
663,12,vid3,2,241,3a,15,256,6,N
664,12,vid4,2,257,4a,16,273,6,N
665,12,vid5,2,273,5,7,280,6,N
666,12,vid1a,3,303,1b,17,320,19,S
667,12,vid1b,3,320,1b,6,326,19,S
668,12,vid2,3,326,2a,11,337,19,S
669,12,vid3,3,337,3b,15,352,19,S
670,12,vid4,3,353,4a,16,369,19,S
671,12,vid5,3,369,5,7,376,19,S
672,12,vid1a,4,400,1b,17,417,38,S
673,12,vid1b,4,416,1b,6,422,38,S
674,12,vid2,4,422,2b,11,433,38,S
675,12,vid3,4,434,3a,15,449,38,S
676,12,vid4,4,449,4b,16,465,38,S
677,12,vid5,4,465,5,7,472,38,S
678,12,vid1a,5,496,1b,17,513,2,N
679,12,vid1b,5,513,1b,6,519,2,N
680,12,vid2,5,519,2b,11,530,2,N
681,12,vid3,5,530,3b,15,545,2,N
682,12,vid4,5,545,4b,16,561,2,N
683,12,vid5,5,561,5,7,568,2,N
684,12,vid1a,6,592,1b,17,609,23,N
685,12,vid1b,6,609,1b,6,615,23,N
686,12,vid2,6,615,2a,11,626,23,N
687,12,vid3,6,626,3a,15,641,23,N
688,12,vid4,6,641,4a,16,657,23,N
689,12,vid5,6,657,5,7,664,23,N
690,12,vid1a,7,689,1b,17,706,1,S
691,12,vid1b,7,705,1b,6,711,1,S
692,12,vid2,7,711,2b,11,722,1,S
693,12,vid3,7,723,3a,15,738,1,S
694,12,vid4,7,738,4b,16,754,1,S
695,12,vid5,7,754,5,7,761,1,S
696,12,vid1a,8,785,1b,17,802,29,S
697,12,vid1b,8,802,1b,6,808,29,S
698,12,vid2,8,808,2a,11,819,29,S
699,12,vid3,8,819,3b,15,834,29,S
700,12,vid4,8,834,4a,16,850,29,S
701,12,vid5,8,850,5,7,857,29,S
702,12,vid1a,9,881,1b,17,898,28,N
703,12,vid1b,9,898,1b,6,904,28,N
704,12,vid2,9,904,2b,11,915,28,N
705,12,vid3,9,915,3b,15,930,28,N
706,12,vid4,9,930,4b,16,946,28,N
707,12,vid5,9,946,5,7,953,28,N
708,12,vid1a,10,978,1b,17,995,20,N
709,12,vid1b,10,995,1b,6,1001,20,N
710,12,vid2,10,1001,2b,11,1012,20,N
711,12,vid3,10,1012,3b,15,1027,20,N
712,12,vid4,10,1027,4b,16,1043,20,N
713,12,vid5,10,1043,5,7,1050,20,N
714,12,vid1a_q,11,1076,1b,17,1093,22,S
715,12,vid1b_q,11,1093,1b,6,1099,22,S
716,12,vid2_q,11,1099,2b,11,1110,22,S
717,12,vid3_q,11,1113,3a,15,1128,22,S
718,12,vid4_q,11,1131,4b,16,1147,22,S
719,12,vid5_q,11,1147,5,7,1154,22,S
720,13,vid1a_q,0,12,1b,17,29,23,S
721,13,vid1b_q,0,29,1b,6,35,23,S
722,13,vid2_q,0,35,2b,11,46,23,S
723,13,vid3_q,0,49,3a,15,64,23,S
724,13,vid4_q,0,67,4b,16,83,23,S
725,13,vid5_q,0,83,5,7,90,23,S
726,13,vid1a,1,112,1b,17,129,38,N
727,13,vid1b,1,128,1b,6,134,38,N
728,13,vid2,1,134,2a,11,145,38,N
729,13,vid3,1,146,3a,15,161,38,N
730,13,vid4,1,161,4a,16,177,38,N
731,13,vid5,1,177,5,7,184,38,N
732,13,vid1a,2,208,1b,17,225,34,N
733,13,vid1b,2,224,1b,6,230,34,N
734,13,vid2,2,230,2b,11,241,34,N
735,13,vid3,2,242,3b,15,257,34,N
736,13,vid4,2,257,4b,16,273,34,N
737,13,vid5,2,273,5,7,280,34,N
738,13,vid1a,3,304,1b,17,321,19,S
739,13,vid1b,3,320,1b,6,326,19,S
740,13,vid2,3,326,2a,11,337,19,S
741,13,vid3,3,338,3b,15,353,19,S
742,13,vid4,3,353,4a,16,369,19,S
743,13,vid5,3,369,5,7,376,19,S
744,13,vid1a,4,400,1b,17,417,1,S
745,13,vid1b,4,417,1b,6,423,1,S
746,13,vid2,4,423,2b,11,434,1,S
747,13,vid3,4,434,3a,15,449,1,S
748,13,vid4,4,449,4b,16,465,1,S
749,13,vid5,4,465,5,7,472,1,S
750,13,vid1a,5,496,1b,17,513,29,N
751,13,vid1b,5,513,1b,6,519,29,N
752,13,vid2,5,519,2a,11,530,29,N
753,13,vid3,5,530,3a,15,545,29,N
754,13,vid4,5,545,4a,16,561,29,N
755,13,vid5,5,561,5,7,568,29,N
756,13,vid1a,6,592,1b,17,609,2,N
757,13,vid1b,6,609,1b,6,615,2,N
758,13,vid2,6,615,2b,11,626,2,N
759,13,vid3,6,626,3b,15,641,2,N
760,13,vid4,6,641,4b,16,657,2,N
761,13,vid5,6,657,5,7,664,2,N
762,13,vid1a,7,689,1b,17,706,28,S
763,13,vid1b,7,705,1b,6,711,28,S
764,13,vid2,7,711,2a,11,722,28,S
765,13,vid3,7,722,3b,15,737,28,S
766,13,vid4,7,738,4a,16,754,28,S
767,13,vid5,7,754,5,7,761,28,S
768,13,vid1a,8,785,1b,17,802,20,S
769,13,vid1b,8,802,1b,6,808,20,S
770,13,vid2,8,808,2a,11,819,20,S
771,13,vid3,8,819,3b,15,834,20,S
772,13,vid4,8,834,4a,16,850,20,S
773,13,vid5,8,850,5,7,857,20,S
774,13,vid1a,9,881,1b,17,898,6,N
775,13,vid1b,9,898,1b,6,904,6,N
776,13,vid2,9,904,2b,11,915,6,N
777,13,vid3,9,915,3b,15,930,6,N
778,13,vid4,9,930,4b,16,946,6,N
779,13,vid5,9,946,5,7,953,6,N
780,13,vid1a,10,978,1b,17,995,17,N
781,13,vid1b,10,994,1b,6,1000,17,N
782,13,vid2,10,1000,2a,11,1011,17,N
783,13,vid3,10,1012,3a,15,1027,17,N
784,13,vid4,10,1027,4a,16,1043,17,N
785,13,vid5,10,1043,5,7,1050,17,N
786,13,vid1a_q,11,1077,1b,17,1094,22,S
787,13,vid1b_q,11,1093,1b,6,1099,22,S
788,13,vid2_q,11,1099,2b,11,1110,22,S
789,13,vid3_q,11,1113,3a,15,1128,22,S
790,13,vid4_q,11,1131,4b,16,1147,22,S
791,13,vid5_q,11,1147,5,7,1154,22,S
792,14,vid1a_q,0,13,1b,17,30,22,S
793,14,vid1b_q,0,29,1b,6,35,22,S
794,14,vid2_q,0,35,2a,11,46,22,S
795,14,vid3_q,0,49,3b,15,64,22,S
796,14,vid4_q,0,67,4a,16,83,22,S
797,14,vid5_q,0,83,5,7,90,22,S
798,14,vid1a,1,112,1b,17,129,28,N
799,14,vid1b,1,129,1b,6,135,28,N
800,14,vid2,1,135,2b,11,146,28,N
801,14,vid3,1,146,3b,15,161,28,N
802,14,vid4,1,161,4b,16,177,28,N
803,14,vid5,1,177,5,7,184,28,N
804,14,vid1a,2,208,1b,17,225,19,N
805,14,vid1b,2,225,1b,6,231,19,N
806,14,vid2,2,231,2a,11,242,19,N
807,14,vid3,2,242,3a,15,257,19,N
808,14,vid4,2,257,4a,16,273,19,N
809,14,vid5,2,273,5,7,280,19,N
810,14,vid1a,3,304,1b,17,321,20,S
811,14,vid1b,3,321,1b,6,327,20,S
812,14,vid2,3,327,2b,11,338,20,S
813,14,vid3,3,338,3a,15,353,20,S
814,14,vid4,3,353,4b,16,369,20,S
815,14,vid5,3,369,5,7,376,20,S
816,14,vid1a,4,399,1b,17,416,1,S
817,14,vid1b,4,416,1b,6,422,1,S
818,14,vid2,4,422,2b,11,433,1,S
819,14,vid3,4,433,3a,15,448,1,S
820,14,vid4,4,449,4b,16,465,1,S
821,14,vid5,4,465,5,7,472,1,S
822,14,vid1a,5,495,1b,17,512,29,N
823,14,vid1b,5,512,1b,6,518,29,N
824,14,vid2,5,518,2a,11,529,29,N
825,14,vid3,5,529,3a,15,544,29,N
826,14,vid4,5,545,4a,16,561,29,N
827,14,vid5,5,561,5,7,568,29,N
828,14,vid1a,6,591,1b,17,608,38,N
829,14,vid1b,6,608,1b,6,614,38,N
830,14,vid2,6,614,2a,11,625,38,N
831,14,vid3,6,625,3a,15,640,38,N
832,14,vid4,6,641,4a,16,657,38,N
833,14,vid5,6,657,5,7,664,38,N
834,14,vid1a,7,687,1b,17,704,23,S
835,14,vid1b,7,704,1b,6,710,23,S
836,14,vid2,7,710,2a,11,721,23,S
837,14,vid3,7,721,3b,15,736,23,S
838,14,vid4,7,737,4a,16,753,23,S
839,14,vid5,7,753,5,7,760,23,S
840,14,vid1a,8,784,1b,17,801,2,S
841,14,vid1b,8,801,1b,6,807,2,S
842,14,vid2,8,807,2a,11,818,2,S
843,14,vid3,8,818,3b,15,833,2,S
844,14,vid4,8,833,4a,16,849,2,S
845,14,vid5,8,849,5,7,856,2,S
846,14,vid1a,9,880,1b,17,897,34,N
847,14,vid1b,9,897,1b,6,903,34,N
848,14,vid2,9,903,2b,11,914,34,N
849,14,vid3,9,914,3b,15,929,34,N
850,14,vid4,9,930,4b,16,946,34,N
851,14,vid5,9,946,5,7,953,34,N
852,14,vid1a,10,976,1b,17,993,17,N
853,14,vid1b,10,993,1b,6,999,17,N
854,14,vid2,10,999,2b,11,1010,17,N
855,14,vid3,10,1010,3b,15,1025,17,N
856,14,vid4,10,1026,4b,16,1042,17,N
857,14,vid5,10,1042,5,7,1049,17,N
858,14,vid1a_q,11,1075,1b,17,1092,6,S
859,14,vid1b_q,11,1092,1b,6,1098,6,S
860,14,vid2_q,11,1098,2b,11,1109,6,S
861,14,vid3_q,11,1112,3a,15,1127,6,S
862,14,vid4_q,11,1130,4b,16,1146,6,S
863,14,vid5_q,11,1146,5,7,1153,6,S
864,15,vid1a_q,0,12,1b,17,29,34,S
865,15,vid1b_q,0,29,1b,6,35,34,S
866,15,vid2_q,0,35,2a,11,46,34,S
867,15,vid3_q,0,49,3b,15,64,34,S
868,15,vid4_q,0,67,4a,16,83,34,S
869,15,vid5_q,0,83,5,7,90,34,S
870,15,vid1a,1,111,1b,17,128,1,N
871,15,vid1b,1,128,1b,6,134,1,N
872,15,vid2,1,134,2a,11,145,1,N
873,15,vid3,1,145,3a,15,160,1,N
874,15,vid4,1,161,4a,16,177,1,N
875,15,vid5,1,177,5,7,184,1,N
876,15,vid1a,2,207,1b,17,224,2,N
877,15,vid1b,2,224,1b,6,230,2,N
878,15,vid2,2,230,2b,11,241,2,N
879,15,vid3,2,241,3b,15,256,2,N
880,15,vid4,2,256,4b,16,272,2,N
881,15,vid5,2,272,5,7,279,2,N
882,15,vid1a,3,303,1b,17,320,19,S
883,15,vid1b,3,320,1b,6,326,19,S
884,15,vid2,3,326,2b,11,337,19,S
885,15,vid3,3,337,3a,15,352,19,S
886,15,vid4,3,352,4b,16,368,19,S
887,15,vid5,3,368,5,7,375,19,S
888,15,vid1a,4,399,1b,17,416,17,S
889,15,vid1b,4,416,1b,6,422,17,S
890,15,vid2,4,422,2a,11,433,17,S
891,15,vid3,4,433,3b,15,448,17,S
892,15,vid4,4,449,4a,16,465,17,S
893,15,vid5,4,465,5,7,472,17,S
894,15,vid1a,5,495,1b,17,512,6,N
895,15,vid1b,5,512,1b,6,518,6,N
896,15,vid2,5,518,2b,11,529,6,N
897,15,vid3,5,529,3b,15,544,6,N
898,15,vid4,5,545,4b,16,561,6,N
899,15,vid5,5,561,5,7,568,6,N
900,15,vid1a,6,591,1b,17,608,28,N
901,15,vid1b,6,608,1b,6,614,28,N
902,15,vid2,6,614,2a,11,625,28,N
903,15,vid3,6,625,3a,15,640,28,N
904,15,vid4,6,641,4a,16,657,28,N
905,15,vid5,6,657,5,7,664,28,N
906,15,vid1a,7,688,1b,17,705,38,S
907,15,vid1b,7,705,1b,6,711,38,S
908,15,vid2,7,711,2b,11,722,38,S
909,15,vid3,7,722,3a,15,737,38,S
910,15,vid4,7,737,4b,16,753,38,S
911,15,vid5,7,753,5,7,760,38,S
912,15,vid1a,8,784,1b,17,801,22,S
913,15,vid1b,8,801,1b,6,807,22,S
914,15,vid2,8,807,2a,11,818,22,S
915,15,vid3,8,818,3b,15,833,22,S
916,15,vid4,8,834,4a,16,850,22,S
917,15,vid5,8,850,5,7,857,22,S
918,15,vid1a,9,880,1b,17,897,20,N
919,15,vid1b,9,897,1b,6,903,20,N
920,15,vid2,9,903,2b,11,914,20,N
921,15,vid3,9,915,3b,15,930,20,N
922,15,vid4,9,930,4b,16,946,20,N
923,15,vid5,9,946,5,7,953,20,N
924,15,vid1a,10,976,1b,17,993,29,N
925,15,vid1b,10,993,1b,6,999,29,N
926,15,vid2,10,999,2a,11,1010,29,N
927,15,vid3,10,1010,3a,15,1025,29,N
928,15,vid4,10,1026,4a,16,1042,29,N
929,15,vid5,10,1042,5,7,1049,29,N
930,15,vid1a_q,11,1074,1b,17,1091,23,S
931,15,vid1b_q,11,1091,1b,6,1097,23,S
932,15,vid2_q,11,1097,2b,11,1108,23,S
933,15,vid3_q,11,1111,3a,15,1126,23,S
934,15,vid4_q,11,1129,4b,16,1145,23,S
935,15,vid5_q,11,1145,5,7,1152,23,S
936,17,vid1a_q,0,12,1b,17,29,22,S
937,17,vid1b_q,0,29,1b,6,35,22,S
938,17,vid2_q,0,35,2b,11,46,22,S
939,17,vid3_q,0,49,3a,15,64,22,S
940,17,vid4_q,0,67,4b,16,83,22,S
941,17,vid5_q,0,83,5,7,90,22,S
942,17,vid1a,1,111,1b,17,128,19,N
943,17,vid1b,1,128,1b,6,134,19,N
944,17,vid2,1,134,2b,11,145,19,N
945,17,vid3,1,145,3b,15,160,19,N
946,17,vid4,1,161,4b,16,177,19,N
947,17,vid5,1,177,5,7,184,19,N
948,17,vid1a,2,207,1b,17,224,29,N
949,17,vid1b,2,224,1b,6,230,29,N
950,17,vid2,2,230,2a,11,241,29,N
951,17,vid3,2,242,3a,15,257,29,N
952,17,vid4,2,257,4a,16,273,29,N
953,17,vid5,2,273,5,7,280,29,N
954,17,vid1a,3,303,1b,17,320,20,S
955,17,vid1b,3,320,1b,6,326,20,S
956,17,vid2,3,326,2a,11,337,20,S
957,17,vid3,3,337,3b,15,352,20,S
958,17,vid4,3,352,4a,16,368,20,S
959,17,vid5,3,368,5,7,375,20,S
960,17,vid1a,4,398,1b,17,415,6,S
961,17,vid1b,4,415,1b,6,421,6,S
962,17,vid2,4,421,2b,11,432,6,S
963,17,vid3,4,432,3a,15,447,6,S
964,17,vid4,4,448,4b,16,464,6,S
965,17,vid5,4,464,5,7,471,6,S
966,17,vid1a,5,494,1b,17,511,34,N
967,17,vid1b,5,511,1b,6,517,34,N
968,17,vid2,5,517,2b,11,528,34,N
969,17,vid3,5,529,3b,15,544,34,N
970,17,vid4,5,544,4b,16,560,34,N
971,17,vid5,5,560,5,7,567,34,N
972,17,vid1a,6,590,1b,17,607,2,N
973,17,vid1b,6,607,1b,6,613,2,N
974,17,vid2,6,613,2a,11,624,2,N
975,17,vid3,6,625,3a,15,640,2,N
976,17,vid4,6,640,4a,16,656,2,N
977,17,vid5,6,656,5,7,663,2,N
978,17,vid1a,7,687,1b,17,704,1,S
979,17,vid1b,7,703,1b,6,709,1,S
980,17,vid2,7,709,2a,11,720,1,S
981,17,vid3,7,721,3b,15,736,1,S
982,17,vid4,7,736,4a,16,752,1,S
983,17,vid5,7,752,5,7,759,1,S
984,17,vid1a,8,783,1b,17,800,38,S
985,17,vid1b,8,799,1b,6,805,38,S
986,17,vid2,8,805,2a,11,816,38,S
987,17,vid3,8,817,3b,15,832,38,S
988,17,vid4,8,832,4a,16,848,38,S
989,17,vid5,8,848,5,7,855,38,S
990,17,vid1a,9,879,1b,17,896,17,N
991,17,vid1b,9,896,1b,6,902,17,N
992,17,vid2,9,902,2b,11,913,17,N
993,17,vid3,9,913,3b,15,928,17,N
994,17,vid4,9,929,4b,16,945,17,N
995,17,vid5,9,945,5,7,952,17,N
996,17,vid1a,10,975,1b,17,992,23,N
997,17,vid1b,10,992,1b,6,998,23,N
998,17,vid2,10,998,2a,11,1009,23,N
999,17,vid3,10,1010,3a,15,1025,23,N
1000,17,vid4,10,1025,4a,16,1041,23,N
1001,17,vid5,10,1041,5,7,1048,23,N
1002,17,vid1a_q,11,1074,1b,17,1091,28,S
1003,17,vid1b_q,11,1091,1b,6,1097,28,S
1004,17,vid2_q,11,1097,2b,11,1108,28,S
1005,17,vid3_q,11,1111,3a,15,1126,28,S
1006,17,vid4_q,11,1129,4b,16,1145,28,S
1007,17,vid5_q,11,1145,5,7,1152,28,S
1008,18,vid1a_q,0,12,1b,17,29,29,S
1009,18,vid1b_q,0,29,1b,6,35,29,S
1010,18,vid2_q,0,35,2b,11,46,29,S
1011,18,vid3_q,0,49,3a,15,64,29,S
1012,18,vid4_q,0,67,4b,16,83,29,S
1013,18,vid5_q,0,83,5,7,90,29,S
1014,18,vid1a,1,111,1b,17,128,22,N
1015,18,vid1b,1,128,1b,6,134,22,N
1016,18,vid2,1,134,2a,11,145,22,N
1017,18,vid3,1,145,3a,15,160,22,N
1018,18,vid4,1,160,4a,16,176,22,N
1019,18,vid5,1,176,5,7,183,22,N
1020,18,vid1a,2,207,1b,17,224,19,N
1021,18,vid1b,2,223,1b,6,229,19,N
1022,18,vid2,2,229,2b,11,240,19,N
1023,18,vid3,2,241,3b,15,256,19,N
1024,18,vid4,2,256,4b,16,272,19,N
1025,18,vid5,2,272,5,7,279,19,N
1026,18,vid1a,3,303,1b,17,320,17,S
1027,18,vid1b,3,320,1b,6,326,17,S
1028,18,vid2,3,326,2a,11,337,17,S
1029,18,vid3,3,337,3b,15,352,17,S
1030,18,vid4,3,352,4a,16,368,17,S
1031,18,vid5,3,368,5,7,375,17,S
1032,18,vid1a,4,399,1b,17,416,34,S
1033,18,vid1b,4,415,1b,6,421,34,S
1034,18,vid2,4,421,2a,11,432,34,S
1035,18,vid3,4,433,3b,15,448,34,S
1036,18,vid4,4,448,4a,16,464,34,S
1037,18,vid5,4,464,5,7,471,34,S
1038,18,vid1a,5,494,1b,17,511,28,N
1039,18,vid1b,5,511,1b,6,517,28,N
1040,18,vid2,5,517,2b,11,528,28,N
1041,18,vid3,5,529,3b,15,544,28,N
1042,18,vid4,5,544,4b,16,560,28,N
1043,18,vid5,5,560,5,7,567,28,N
1044,18,vid1a,6,591,1b,17,608,20,N
1045,18,vid1b,6,608,1b,6,614,20,N
1046,18,vid2,6,614,2a,11,625,20,N
1047,18,vid3,6,625,3a,15,640,20,N
1048,18,vid4,6,640,4a,16,656,20,N
1049,18,vid5,6,656,5,7,663,20,N
1050,18,vid1a,7,686,1b,17,703,2,S
1051,18,vid1b,7,703,1b,6,709,2,S
1052,18,vid2,7,709,2a,11,720,2,S
1053,18,vid3,7,720,3b,15,735,2,S
1054,18,vid4,7,736,4a,16,752,2,S
1055,18,vid5,7,752,5,7,759,2,S
1056,18,vid1a,8,782,1b,17,799,38,S
1057,18,vid1b,8,799,1b,6,805,38,S
1058,18,vid2,8,805,2b,11,816,38,S
1059,18,vid3,8,817,3a,15,832,38,S
1060,18,vid4,8,832,4b,16,848,38,S
1061,18,vid5,8,848,5,7,855,38,S
1062,18,vid1a,9,879,1b,17,896,1,N
1063,18,vid1b,9,896,1b,6,902,1,N
1064,18,vid2,9,902,2b,11,913,1,N
1065,18,vid3,9,913,3b,15,928,1,N
1066,18,vid4,9,928,4b,16,944,1,N
1067,18,vid5,9,944,5,7,951,1,N
1068,18,vid1a,10,975,1b,17,992,6,N
1069,18,vid1b,10,992,1b,6,998,6,N
1070,18,vid2,10,998,2a,11,1009,6,N
1071,18,vid3,10,1009,3a,15,1024,6,N
1072,18,vid4,10,1024,4a,16,1040,6,N
1073,18,vid5,10,1040,5,7,1047,6,N
1074,18,vid1a_q,11,1074,1b,17,1091,23,S
1075,18,vid1b_q,11,1090,1b,6,1096,23,S
1076,18,vid2_q,11,1096,2b,11,1107,23,S
1077,18,vid3_q,11,1110,3a,15,1125,23,S
1078,18,vid4_q,11,1128,4b,16,1144,23,S
1079,18,vid5_q,11,1144,5,7,1151,23,S
1080,19,vid1a_q,0,12,1b,17,29,20,S
1081,19,vid1b_q,0,29,1b,6,35,20,S
1082,19,vid2_q,0,35,2b,11,46,20,S
1083,19,vid3_q,0,49,3a,15,64,20,S
1084,19,vid4_q,0,67,4b,16,83,20,S
1085,19,vid5_q,0,83,5,7,90,20,S
1086,19,vid1a,1,111,1b,17,128,28,N
1087,19,vid1b,1,128,1b,6,134,28,N
1088,19,vid2,1,134,2b,11,145,28,N
1089,19,vid3,1,145,3b,15,160,28,N
1090,19,vid4,1,160,4b,16,176,28,N
1091,19,vid5,1,176,5,7,183,28,N
1092,19,vid1a,2,207,1b,17,224,17,N
1093,19,vid1b,2,224,1b,6,230,17,N
1094,19,vid2,2,230,2b,11,241,17,N
1095,19,vid3,2,241,3b,15,256,17,N
1096,19,vid4,2,256,4b,16,272,17,N
1097,19,vid5,2,272,5,7,279,17,N
1098,19,vid1a,3,303,1b,17,320,1,S
1099,19,vid1b,3,320,1b,6,326,1,S
1100,19,vid2,3,326,2a,11,337,1,S
1101,19,vid3,3,337,3b,15,352,1,S
1102,19,vid4,3,352,4a,16,368,1,S
1103,19,vid5,3,368,5,7,375,1,S
1104,19,vid1a,4,399,1b,17,416,38,S
1105,19,vid1b,4,416,1b,6,422,38,S
1106,19,vid2,4,422,2b,11,433,38,S
1107,19,vid3,4,433,3a,15,448,38,S
1108,19,vid4,4,448,4b,16,464,38,S
1109,19,vid5,4,464,5,7,471,38,S
1110,19,vid1a,5,495,1b,17,512,29,N
1111,19,vid1b,5,512,1b,6,518,29,N
1112,19,vid2,5,518,2a,11,529,29,N
1113,19,vid3,5,529,3a,15,544,29,N
1114,19,vid4,5,544,4a,16,560,29,N
1115,19,vid5,5,560,5,7,567,29,N
1116,19,vid1a,6,591,1b,17,608,2,N
1117,19,vid1b,6,607,1b,6,613,2,N
1118,19,vid2,6,613,2a,11,624,2,N
1119,19,vid3,6,625,3a,15,640,2,N
1120,19,vid4,6,640,4a,16,656,2,N
1121,19,vid5,6,656,5,7,663,2,N
1122,19,vid1a,7,687,1b,17,704,22,S
1123,19,vid1b,7,704,1b,6,710,22,S
1124,19,vid2,7,710,2a,11,721,22,S
1125,19,vid3,7,721,3b,15,736,22,S
1126,19,vid4,7,736,4a,16,752,22,S
1127,19,vid5,7,752,5,7,759,22,S
1128,19,vid1a,8,783,1b,17,800,23,S
1129,19,vid1b,8,800,1b,6,806,23,S
1130,19,vid2,8,806,2b,11,817,23,S
1131,19,vid3,8,817,3a,15,832,23,S
1132,19,vid4,8,832,4b,16,848,23,S
1133,19,vid5,8,848,5,7,855,23,S
1134,19,vid1a,9,880,1b,17,897,6,N
1135,19,vid1b,9,896,1b,6,902,6,N
1136,19,vid2,9,902,2b,11,913,6,N
1137,19,vid3,9,914,3b,15,929,6,N
1138,19,vid4,9,929,4b,16,945,6,N
1139,19,vid5,9,945,5,7,952,6,N
1140,19,vid1a,10,976,1b,17,993,34,N
1141,19,vid1b,10,993,1b,6,999,34,N
1142,19,vid2,10,999,2a,11,1010,34,N
1143,19,vid3,10,1010,3a,15,1025,34,N
1144,19,vid4,10,1025,4a,16,1041,34,N
1145,19,vid5,10,1041,5,7,1048,34,N
1146,19,vid1a_q,11,1075,1b,17,1092,19,S
1147,19,vid1b_q,11,1091,1b,6,1097,19,S
1148,19,vid2_q,11,1097,2a,11,1108,19,S
1149,19,vid3_q,11,1111,3b,15,1126,19,S
1150,19,vid4_q,11,1129,4a,16,1145,19,S
1151,19,vid5_q,11,1145,5,7,1152,19,S
1152,22,vid1a_q,0,12,1b,17,29,28,S
1153,22,vid1b_q,0,29,1b,6,35,28,S
1154,22,vid2_q,0,35,2b,11,46,28,S
1155,22,vid3_q,0,49,3a,15,64,28,S
1156,22,vid4_q,0,67,4b,16,83,28,S
1157,22,vid5_q,0,83,5,7,90,28,S
1158,22,vid1a,1,111,1b,17,128,38,N
1159,22,vid1b,1,128,1b,6,134,38,N
1160,22,vid2,1,134,2a,11,145,38,N
1161,22,vid3,1,146,3a,15,161,38,N
1162,22,vid4,1,161,4a,16,177,38,N
1163,22,vid5,1,177,5,7,184,38,N
1164,22,vid1a,2,207,1b,17,224,22,N
1165,22,vid1b,2,224,1b,6,230,22,N
1166,22,vid2,2,230,2b,11,241,22,N
1167,22,vid3,2,241,3b,15,256,22,N
1168,22,vid4,2,257,4b,16,273,22,N
1169,22,vid5,2,273,5,7,280,22,N
1170,22,vid1a,3,303,1b,17,320,20,S
1171,22,vid1b,3,320,1b,6,326,20,S
1172,22,vid2,3,326,2a,11,337,20,S
1173,22,vid3,3,337,3b,15,352,20,S
1174,22,vid4,3,353,4a,16,369,20,S
1175,22,vid5,3,369,5,7,376,20,S
1176,22,vid1a,4,398,1b,17,415,2,S
1177,22,vid1b,4,415,1b,6,421,2,S
1178,22,vid2,4,421,2a,11,432,2,S
1179,22,vid3,4,432,3b,15,447,2,S
1180,22,vid4,4,448,4a,16,464,2,S
1181,22,vid5,4,464,5,7,471,2,S
1182,22,vid1a,5,494,1b,17,511,23,N
1183,22,vid1b,5,511,1b,6,517,23,N
1184,22,vid2,5,517,2a,11,528,23,N
1185,22,vid3,5,528,3a,15,543,23,N
1186,22,vid4,5,544,4a,16,560,23,N
1187,22,vid5,5,560,5,7,567,23,N
1188,22,vid1a,6,591,1b,17,608,1,N
1189,22,vid1b,6,607,1b,6,613,1,N
1190,22,vid2,6,613,2b,11,624,1,N
1191,22,vid3,6,625,3b,15,640,1,N
1192,22,vid4,6,640,4b,16,656,1,N
1193,22,vid5,6,656,5,7,663,1,N
1194,22,vid1a,7,687,1b,17,704,34,S
1195,22,vid1b,7,704,1b,6,710,34,S
1196,22,vid2,7,710,2b,11,721,34,S
1197,22,vid3,7,721,3a,15,736,34,S
1198,22,vid4,7,736,4b,16,752,34,S
1199,22,vid5,7,752,5,7,759,34,S
1200,22,vid1a,8,783,1b,17,800,19,S
1201,22,vid1b,8,799,1b,6,805,19,S
1202,22,vid2,8,805,2a,11,816,19,S
1203,22,vid3,8,817,3b,15,832,19,S
1204,22,vid4,8,832,4a,16,848,19,S
1205,22,vid5,8,848,5,7,855,19,S
1206,22,vid1a,9,879,1b,17,896,6,N
1207,22,vid1b,9,896,1b,6,902,6,N
1208,22,vid2,9,902,2b,11,913,6,N
1209,22,vid3,9,913,3b,15,928,6,N
1210,22,vid4,9,929,4b,16,945,6,N
1211,22,vid5,9,945,5,7,952,6,N
1212,22,vid1a,10,976,1b,17,993,29,N
1213,22,vid1b,10,992,1b,6,998,29,N
1214,22,vid2,10,998,2a,11,1009,29,N
1215,22,vid3,10,1010,3a,15,1025,29,N
1216,22,vid4,10,1025,4a,16,1041,29,N
1217,22,vid5,10,1041,5,7,1048,29,N
1218,22,vid1a_q,11,1074,1b,17,1091,17,S
1219,22,vid1b_q,11,1091,1b,6,1097,17,S
1220,22,vid2_q,11,1097,2b,11,1108,17,S
1221,22,vid3_q,11,1111,3a,15,1126,17,S
1222,22,vid4_q,11,1129,4b,16,1145,17,S
1223,22,vid5_q,11,1145,5,7,1152,17,S
1224,23,vid1a_q,0,12,1b,17,29,28,S
1225,23,vid1b_q,0,29,1b,6,35,28,S
1226,23,vid2_q,0,35,2a,11,46,28,S
1227,23,vid3_q,0,49,3b,15,64,28,S
1228,23,vid4_q,0,67,4a,16,83,28,S
1229,23,vid5_q,0,83,5,7,90,28,S
1230,23,vid1a,1,112,1b,17,129,22,N
1231,23,vid1b,1,128,1b,6,134,22,N
1232,23,vid2,1,134,2a,11,145,22,N
1233,23,vid3,1,146,3a,15,161,22,N
1234,23,vid4,1,161,4a,16,177,22,N
1235,23,vid5,1,177,5,7,184,22,N
1236,23,vid1a,2,208,1b,17,225,6,N
1237,23,vid1b,2,224,1b,6,230,6,N
1238,23,vid2,2,230,2a,11,241,6,N
1239,23,vid3,2,242,3a,15,257,6,N
1240,23,vid4,2,257,4a,16,273,6,N
1241,23,vid5,2,273,5,7,280,6,N
1242,23,vid1a,3,304,1b,17,321,38,S
1243,23,vid1b,3,320,1b,6,326,38,S
1244,23,vid2,3,326,2a,11,337,38,S
1245,23,vid3,3,338,3b,15,353,38,S
1246,23,vid4,3,353,4a,16,369,38,S
1247,23,vid5,3,369,5,7,376,38,S
1248,23,vid1a,4,400,1b,17,417,2,S
1249,23,vid1b,4,416,1b,6,422,2,S
1250,23,vid2,4,422,2b,11,433,2,S
1251,23,vid3,4,434,3a,15,449,2,S
1252,23,vid4,4,449,4b,16,465,2,S
1253,23,vid5,4,465,5,7,472,2,S
1254,23,vid1a,5,496,1b,17,513,34,N
1255,23,vid1b,5,512,1b,6,518,34,N
1256,23,vid2,5,518,2b,11,529,34,N
1257,23,vid3,5,530,3b,15,545,34,N
1258,23,vid4,5,545,4b,16,561,34,N
1259,23,vid5,5,561,5,7,568,34,N
1260,23,vid1a,6,592,1b,17,609,23,N
1261,23,vid1b,6,608,1b,6,614,23,N
1262,23,vid2,6,614,2b,11,625,23,N
1263,23,vid3,6,626,3b,15,641,23,N
1264,23,vid4,6,641,4b,16,657,23,N
1265,23,vid5,6,657,5,7,664,23,N
1266,23,vid1a,7,688,1b,17,705,1,S
1267,23,vid1b,7,705,1b,6,711,1,S
1268,23,vid2,7,711,2a,11,722,1,S
1269,23,vid3,7,722,3b,15,737,1,S
1270,23,vid4,7,738,4a,16,754,1,S
1271,23,vid5,7,754,5,7,761,1,S
1272,23,vid1a,8,784,1b,17,801,19,S
1273,23,vid1b,8,801,1b,6,807,19,S
1274,23,vid2,8,807,2b,11,818,19,S
1275,23,vid3,8,818,3a,15,833,19,S
1276,23,vid4,8,834,4b,16,850,19,S
1277,23,vid5,8,850,5,7,857,19,S
1278,23,vid1a,9,881,1b,17,898,17,N
1279,23,vid1b,9,898,1b,6,904,17,N
1280,23,vid2,9,904,2a,11,915,17,N
1281,23,vid3,9,915,3a,15,930,17,N
1282,23,vid4,9,930,4a,16,946,17,N
1283,23,vid5,9,946,5,7,953,17,N
1284,23,vid1a,10,977,1b,17,994,20,N
1285,23,vid1b,10,994,1b,6,1000,20,N
1286,23,vid2,10,1000,2b,11,1011,20,N
1287,23,vid3,10,1011,3b,15,1026,20,N
1288,23,vid4,10,1027,4b,16,1043,20,N
1289,23,vid5,10,1043,5,7,1050,20,N
1290,23,vid1a_q,11,1075,1b,17,1092,29,S
1291,23,vid1b_q,11,1092,1b,6,1098,29,S
1292,23,vid2_q,11,1098,2b,11,1109,29,S
1293,23,vid3_q,11,1112,3a,15,1127,29,S
1294,23,vid4_q,11,1130,4b,16,1146,29,S
1295,23,vid5_q,11,1146,5,7,1153,29,S
1296,24,vid1a_q,0,13,1b,17,30,22,S
1297,24,vid1b_q,0,29,1b,6,35,22,S
1298,24,vid2_q,0,35,2a,11,46,22,S
1299,24,vid3_q,0,49,3b,15,64,22,S
1300,24,vid4_q,0,67,4a,16,83,22,S
1301,24,vid5_q,0,83,5,7,90,22,S
1302,24,vid1a,1,112,1b,17,129,20,N
1303,24,vid1b,1,128,1b,6,134,20,N
1304,24,vid2,1,134,2b,11,145,20,N
1305,24,vid3,1,146,3b,15,161,20,N
1306,24,vid4,1,161,4b,16,177,20,N
1307,24,vid5,1,177,5,7,184,20,N
1308,24,vid1a,2,207,1b,17,224,17,N
1309,24,vid1b,2,224,1b,6,230,17,N
1310,24,vid2,2,230,2a,11,241,17,N
1311,24,vid3,2,241,3a,15,256,17,N
1312,24,vid4,2,256,4a,16,272,17,N
1313,24,vid5,2,272,5,7,279,17,N
1314,24,vid1a,3,303,1b,17,320,34,S
1315,24,vid1b,3,319,1b,6,325,34,S
1316,24,vid2,3,325,2a,11,336,34,S
1317,24,vid3,3,337,3b,15,352,34,S
1318,24,vid4,3,352,4a,16,368,34,S
1319,24,vid5,3,368,5,7,375,34,S
1320,24,vid1a,4,398,1b,17,415,2,S
1321,24,vid1b,4,415,1b,6,421,2,S
1322,24,vid2,4,421,2a,11,432,2,S
1323,24,vid3,4,433,3b,15,448,2,S
1324,24,vid4,4,448,4a,16,464,2,S
1325,24,vid5,4,464,5,7,471,2,S
1326,24,vid1a,5,494,1b,17,511,23,N
1327,24,vid1b,5,511,1b,6,517,23,N
1328,24,vid2,5,517,2a,11,528,23,N
1329,24,vid3,5,529,3a,15,544,23,N
1330,24,vid4,5,544,4a,16,560,23,N
1331,24,vid5,5,560,5,7,567,23,N
1332,24,vid1a,6,591,1b,17,608,1,N
1333,24,vid1b,6,608,1b,6,614,1,N
1334,24,vid2,6,614,2b,11,625,1,N
1335,24,vid3,6,625,3b,15,640,1,N
1336,24,vid4,6,640,4b,16,656,1,N
1337,24,vid5,6,656,5,7,663,1,N
1338,24,vid1a,7,687,1b,17,704,38,S
1339,24,vid1b,7,704,1b,6,710,38,S
1340,24,vid2,7,710,2b,11,721,38,S
1341,24,vid3,7,721,3a,15,736,38,S
1342,24,vid4,7,736,4b,16,752,38,S
1343,24,vid5,7,752,5,7,759,38,S
1344,24,vid1a,8,783,1b,17,800,6,S
1345,24,vid1b,8,800,1b,6,806,6,S
1346,24,vid2,8,806,2b,11,817,6,S
1347,24,vid3,8,817,3a,15,832,6,S
1348,24,vid4,8,833,4b,16,849,6,S
1349,24,vid5,8,849,5,7,856,6,S
1350,24,vid1a,9,879,1b,17,896,28,N
1351,24,vid1b,9,896,1b,6,902,28,N
1352,24,vid2,9,902,2a,11,913,28,N
1353,24,vid3,9,914,3a,15,929,28,N
1354,24,vid4,9,929,4a,16,945,28,N
1355,24,vid5,9,945,5,7,952,28,N
1356,24,vid1a,10,976,1b,17,993,29,N
1357,24,vid1b,10,993,1b,6,999,29,N
1358,24,vid2,10,999,2b,11,1010,29,N
1359,24,vid3,10,1010,3b,15,1025,29,N
1360,24,vid4,10,1025,4b,16,1041,29,N
1361,24,vid5,10,1041,5,7,1048,29,N
1362,24,vid1a_q,11,1074,1b,17,1091,19,S
1363,24,vid1b_q,11,1091,1b,6,1097,19,S
1364,24,vid2_q,11,1097,2b,11,1108,19,S
1365,24,vid3_q,11,1111,3a,15,1126,19,S
1366,24,vid4_q,11,1129,4b,16,1145,19,S
1367,24,vid5_q,11,1145,5,7,1152,19,S
1368,25,vid1a_q,0,12,1b,17,29,20,S
1369,25,vid1b_q,0,29,1b,6,35,20,S
1370,25,vid2_q,0,35,2a,11,46,20,S
1371,25,vid3_q,0,49,3b,15,64,20,S
1372,25,vid4_q,0,67,4a,16,83,20,S
1373,25,vid5_q,0,83,5,7,90,20,S
1374,25,vid1a,1,111,1b,17,128,19,N
1375,25,vid1b,1,127,1b,6,133,19,N
1376,25,vid2,1,133,2a,11,144,19,N
1377,25,vid3,1,145,3a,15,160,19,N
1378,25,vid4,1,160,4a,16,176,19,N
1379,25,vid5,1,176,5,7,183,19,N
1380,25,vid1a,2,207,1b,17,224,28,N
1381,25,vid1b,2,224,1b,6,230,28,N
1382,25,vid2,2,230,2b,11,241,28,N
1383,25,vid3,2,241,3b,15,256,28,N
1384,25,vid4,2,256,4b,16,272,28,N
1385,25,vid5,2,272,5,7,279,28,N
1386,25,vid1a,3,303,1b,17,320,17,S
1387,25,vid1b,3,320,1b,6,326,17,S
1388,25,vid2,3,326,2b,11,337,17,S
1389,25,vid3,3,337,3a,15,352,17,S
1390,25,vid4,3,352,4b,16,368,17,S
1391,25,vid5,3,368,5,7,375,17,S
1392,25,vid1a,4,399,1b,17,416,2,S
1393,25,vid1b,4,415,1b,6,421,2,S
1394,25,vid2,4,421,2a,11,432,2,S
1395,25,vid3,4,433,3b,15,448,2,S
1396,25,vid4,4,448,4a,16,464,2,S
1397,25,vid5,4,464,5,7,471,2,S
1398,25,vid1a,5,495,1b,17,512,6,N
1399,25,vid1b,5,511,1b,6,517,6,N
1400,25,vid2,5,517,2a,11,528,6,N
1401,25,vid3,5,529,3a,15,544,6,N
1402,25,vid4,5,544,4a,16,560,6,N
1403,25,vid5,5,560,5,7,567,6,N
1404,25,vid1a,6,591,1b,17,608,38,N
1405,25,vid1b,6,608,1b,6,614,38,N
1406,25,vid2,6,614,2b,11,625,38,N
1407,25,vid3,6,625,3b,15,640,38,N
1408,25,vid4,6,640,4b,16,656,38,N
1409,25,vid5,6,656,5,7,663,38,N
1410,25,vid1a,7,687,1b,17,704,34,S
1411,25,vid1b,7,704,1b,6,710,34,S
1412,25,vid2,7,710,2b,11,721,34,S
1413,25,vid3,7,721,3a,15,736,34,S
1414,25,vid4,7,736,4b,16,752,34,S
1415,25,vid5,7,752,5,7,759,34,S
1416,25,vid1a,8,783,1b,17,800,23,S
1417,25,vid1b,8,800,1b,6,806,23,S
1418,25,vid2,8,806,2a,11,817,23,S
1419,25,vid3,8,817,3b,15,832,23,S
1420,25,vid4,8,832,4a,16,848,23,S
1421,25,vid5,8,848,5,7,855,23,S
1422,25,vid1a,9,880,1b,17,897,22,N
1423,25,vid1b,9,896,1b,6,902,22,N
1424,25,vid2,9,902,2b,11,913,22,N
1425,25,vid3,9,914,3b,15,929,22,N
1426,25,vid4,9,929,4b,16,945,22,N
1427,25,vid5,9,945,5,7,952,22,N
1428,25,vid1a,10,976,1b,17,993,29,N
1429,25,vid1b,10,993,1b,6,999,29,N
1430,25,vid2,10,999,2a,11,1010,29,N
1431,25,vid3,10,1010,3a,15,1025,29,N
1432,25,vid4,10,1025,4a,16,1041,29,N
1433,25,vid5,10,1041,5,7,1048,29,N
1434,25,vid1a_q,11,1074,1b,17,1091,1,S
1435,25,vid1b_q,11,1091,1b,6,1097,1,S
1436,25,vid2_q,11,1097,2b,11,1108,1,S
1437,25,vid3_q,11,1111,3a,15,1126,1,S
1438,25,vid4_q,11,1129,4b,16,1145,1,S
1439,25,vid5_q,11,1145,5,7,1152,1,S
1440,26,vid1a_q,0,13,1b,17,30,22,S
1441,26,vid1b_q,0,29,1b,6,35,22,S
1442,26,vid2_q,0,35,2b,11,46,22,S
1443,26,vid3_q,0,49,3a,15,64,22,S
1444,26,vid4_q,0,67,4b,16,83,22,S
1445,26,vid5_q,0,83,5,7,90,22,S
1446,26,vid1a,1,112,1b,17,129,38,N
1447,26,vid1b,1,129,1b,6,135,38,N
1448,26,vid2,1,135,2b,11,146,38,N
1449,26,vid3,1,146,3b,15,161,38,N
1450,26,vid4,1,161,4b,16,177,38,N
1451,26,vid5,1,177,5,7,184,38,N
1452,26,vid1a,2,208,1b,17,225,20,N
1453,26,vid1b,2,224,1b,6,230,20,N
1454,26,vid2,2,230,2a,11,241,20,N
1455,26,vid3,2,242,3a,15,257,20,N
1456,26,vid4,2,257,4a,16,273,20,N
1457,26,vid5,2,273,5,7,280,20,N
1458,26,vid1a,3,303,1b,17,320,29,S
1459,26,vid1b,3,320,1b,6,326,29,S
1460,26,vid2,3,326,2a,11,337,29,S
1461,26,vid3,3,337,3b,15,352,29,S
1462,26,vid4,3,352,4a,16,368,29,S
1463,26,vid5,3,368,5,7,375,29,S
1464,26,vid1a,4,399,1b,17,416,19,S
1465,26,vid1b,4,415,1b,6,421,19,S
1466,26,vid2,4,421,2b,11,432,19,S
1467,26,vid3,4,433,3a,15,448,19,S
1468,26,vid4,4,448,4b,16,464,19,S
1469,26,vid5,4,464,5,7,471,19,S
1470,26,vid1a,5,495,1b,17,512,23,N
1471,26,vid1b,5,512,1b,6,518,23,N
1472,26,vid2,5,518,2b,11,529,23,N
1473,26,vid3,5,529,3b,15,544,23,N
1474,26,vid4,5,544,4b,16,560,23,N
1475,26,vid5,5,560,5,7,567,23,N
1476,26,vid1a,6,592,1b,17,609,34,N
1477,26,vid1b,6,608,1b,6,614,34,N
1478,26,vid2,6,614,2a,11,625,34,N
1479,26,vid3,6,626,3a,15,641,34,N
1480,26,vid4,6,641,4a,16,657,34,N
1481,26,vid5,6,657,5,7,664,34,N
1482,26,vid1a,7,688,1b,17,705,2,S
1483,26,vid1b,7,704,1b,6,710,2,S
1484,26,vid2,7,710,2b,11,721,2,S
1485,26,vid3,7,722,3a,15,737,2,S
1486,26,vid4,7,737,4b,16,753,2,S
1487,26,vid5,7,753,5,7,760,2,S
1488,26,vid1a,8,784,1b,17,801,28,S
1489,26,vid1b,8,801,1b,6,807,28,S
1490,26,vid2,8,807,2a,11,818,28,S
1491,26,vid3,8,818,3b,15,833,28,S
1492,26,vid4,8,833,4a,16,849,28,S
1493,26,vid5,8,849,5,7,856,28,S
1494,26,vid1a,9,881,1b,17,898,6,N
1495,26,vid1b,9,897,1b,6,903,6,N
1496,26,vid2,9,903,2b,11,914,6,N
1497,26,vid3,9,915,3b,15,930,6,N
1498,26,vid4,9,930,4b,16,946,6,N
1499,26,vid5,9,946,5,7,953,6,N
1500,26,vid1a,10,977,1b,17,994,17,N
1501,26,vid1b,10,994,1b,6,1000,17,N
1502,26,vid2,10,1000,2a,11,1011,17,N
1503,26,vid3,10,1011,3a,15,1026,17,N
1504,26,vid4,10,1026,4a,16,1042,17,N
1505,26,vid5,10,1042,5,7,1049,17,N
1506,26,vid1a_q,11,1076,1b,17,1093,1,S
1507,26,vid1b_q,11,1092,1b,6,1098,1,S
1508,26,vid2_q,11,1098,2a,11,1109,1,S
1509,26,vid3_q,11,1112,3b,15,1127,1,S
1510,26,vid4_q,11,1130,4a,16,1146,1,S
1511,26,vid5_q,11,1146,5,7,1153,1,S
1512,27,vid1a_q,0,12,1b,17,29,22,S
1513,27,vid1b_q,0,29,1b,6,35,22,S
1514,27,vid2_q,0,35,2a,11,46,22,S
1515,27,vid3_q,0,49,3b,15,64,22,S
1516,27,vid4_q,0,67,4a,16,83,22,S
1517,27,vid5_q,0,83,5,7,90,22,S
1518,27,vid1a,1,111,1b,17,128,29,N
1519,27,vid1b,1,128,1b,6,134,29,N
1520,27,vid2,1,134,2b,11,145,29,N
1521,27,vid3,1,146,3b,15,161,29,N
1522,27,vid4,1,161,4b,16,177,29,N
1523,27,vid5,1,177,5,7,184,29,N
1524,27,vid1a,2,207,1b,17,224,34,N
1525,27,vid1b,2,224,1b,6,230,34,N
1526,27,vid2,2,230,2a,11,241,34,N
1527,27,vid3,2,241,3a,15,256,34,N
1528,27,vid4,2,256,4a,16,272,34,N
1529,27,vid5,2,272,5,7,279,34,N
1530,27,vid1a,3,303,1b,17,320,23,S
1531,27,vid1b,3,319,1b,6,325,23,S
1532,27,vid2,3,325,2b,11,336,23,S
1533,27,vid3,3,337,3a,15,352,23,S
1534,27,vid4,3,352,4b,16,368,23,S
1535,27,vid5,3,368,5,7,375,23,S
1536,27,vid1a,4,399,1b,17,416,20,S
1537,27,vid1b,4,416,1b,6,422,20,S
1538,27,vid2,4,422,2a,11,433,20,S
1539,27,vid3,4,433,3b,15,448,20,S
1540,27,vid4,4,448,4a,16,464,20,S
1541,27,vid5,4,464,5,7,471,20,S
1542,27,vid1a,5,494,1b,17,511,1,N
1543,27,vid1b,5,511,1b,6,517,1,N
1544,27,vid2,5,517,2b,11,528,1,N
1545,27,vid3,5,528,3b,15,543,1,N
1546,27,vid4,5,544,4b,16,560,1,N
1547,27,vid5,5,560,5,7,567,1,N
1548,27,vid1a,6,590,1b,17,607,2,N
1549,27,vid1b,6,607,1b,6,613,2,N
1550,27,vid2,6,613,2b,11,624,2,N
1551,27,vid3,6,624,3b,15,639,2,N
1552,27,vid4,6,640,4b,16,656,2,N
1553,27,vid5,6,656,5,7,663,2,N
1554,27,vid1a,7,687,1b,17,704,6,S
1555,27,vid1b,7,703,1b,6,709,6,S
1556,27,vid2,7,709,2a,11,720,6,S
1557,27,vid3,7,721,3b,15,736,6,S
1558,27,vid4,7,736,4a,16,752,6,S
1559,27,vid5,7,752,5,7,759,6,S
1560,27,vid1a,8,783,1b,17,800,17,S
1561,27,vid1b,8,800,1b,6,806,17,S
1562,27,vid2,8,806,2b,11,817,17,S
1563,27,vid3,8,817,3a,15,832,17,S
1564,27,vid4,8,832,4b,16,848,17,S
1565,27,vid5,8,848,5,7,855,17,S
1566,27,vid1a,9,879,1b,17,896,28,N
1567,27,vid1b,9,896,1b,6,902,28,N
1568,27,vid2,9,902,2a,11,913,28,N
1569,27,vid3,9,913,3a,15,928,28,N
1570,27,vid4,9,929,4a,16,945,28,N
1571,27,vid5,9,945,5,7,952,28,N
1572,27,vid1a,10,976,1b,17,993,19,N
1573,27,vid1b,10,993,1b,6,999,19,N
1574,27,vid2,10,999,2a,11,1010,19,N
1575,27,vid3,10,1010,3a,15,1025,19,N
1576,27,vid4,10,1025,4a,16,1041,19,N
1577,27,vid5,10,1041,5,7,1048,19,N
1578,27,vid1a_q,11,1075,1b,17,1092,38,S
1579,27,vid1b_q,11,1092,1b,6,1098,38,S
1580,27,vid2_q,11,1098,2b,11,1109,38,S
1581,27,vid3_q,11,1112,3a,15,1127,38,S
1582,27,vid4_q,11,1130,4b,16,1146,38,S
1583,27,vid5_q,11,1146,5,7,1153,38,S
1584,28,vid1a_q,0,12,1b,17,29,22,S
1585,28,vid1b_q,0,29,1b,6,35,22,S
1586,28,vid2_q,0,35,2b,11,46,22,S
1587,28,vid3_q,0,49,3a,15,64,22,S
1588,28,vid4_q,0,67,4b,16,83,22,S
1589,28,vid5_q,0,83,5,7,90,22,S
1590,28,vid1a,1,111,1b,17,128,28,N
1591,28,vid1b,1,128,1b,6,134,28,N
1592,28,vid2,1,134,2a,11,145,28,N
1593,28,vid3,1,145,3a,15,160,28,N
1594,28,vid4,1,161,4a,16,177,28,N
1595,28,vid5,1,177,5,7,184,28,N
1596,28,vid1a,2,207,1b,17,224,17,N
1597,28,vid1b,2,224,1b,6,230,17,N
1598,28,vid2,2,230,2b,11,241,17,N
1599,28,vid3,2,241,3b,15,256,17,N
1600,28,vid4,2,257,4b,16,273,17,N
1601,28,vid5,2,273,5,7,280,17,N
1602,28,vid1a,3,303,1b,17,320,6,S
1603,28,vid1b,3,320,1b,6,326,6,S
1604,28,vid2,3,326,2b,11,337,6,S
1605,28,vid3,3,337,3a,15,352,6,S
1606,28,vid4,3,353,4b,16,369,6,S
1607,28,vid5,3,369,5,7,376,6,S
1608,28,vid1a,4,399,1b,17,416,2,S
1609,28,vid1b,4,416,1b,6,422,2,S
1610,28,vid2,4,422,2a,11,433,2,S
1611,28,vid3,4,433,3b,15,448,2,S
1612,28,vid4,4,449,4a,16,465,2,S
1613,28,vid5,4,465,5,7,472,2,S
1614,28,vid1a,5,495,1b,17,512,19,N
1615,28,vid1b,5,512,1b,6,518,19,N
1616,28,vid2,5,518,2a,11,529,19,N
1617,28,vid3,5,529,3a,15,544,19,N
1618,28,vid4,5,545,4a,16,561,19,N
1619,28,vid5,5,561,5,7,568,19,N
1620,28,vid1a,6,592,1b,17,609,1,N
1621,28,vid1b,6,608,1b,6,614,1,N
1622,28,vid2,6,614,2a,11,625,1,N
1623,28,vid3,6,626,3a,15,641,1,N
1624,28,vid4,6,641,4a,16,657,1,N
1625,28,vid5,6,657,5,7,664,1,N
1626,28,vid1a,7,688,1b,17,705,34,S
1627,28,vid1b,7,704,1b,6,710,34,S
1628,28,vid2,7,710,2a,11,721,34,S
1629,28,vid3,7,722,3b,15,737,34,S
1630,28,vid4,7,737,4a,16,753,34,S
1631,28,vid5,7,753,5,7,760,34,S
1632,28,vid1a,8,784,1b,17,801,38,S
1633,28,vid1b,8,801,1b,6,807,38,S
1634,28,vid2,8,807,2b,11,818,38,S
1635,28,vid3,8,818,3a,15,833,38,S
1636,28,vid4,8,833,4b,16,849,38,S
1637,28,vid5,8,849,5,7,856,38,S
1638,28,vid1a,9,880,1b,17,897,20,N
1639,28,vid1b,9,897,1b,6,903,20,N
1640,28,vid2,9,903,2b,11,914,20,N
1641,28,vid3,9,914,3b,15,929,20,N
1642,28,vid4,9,930,4b,16,946,20,N
1643,28,vid5,9,946,5,7,953,20,N
1644,28,vid1a,10,976,1b,17,993,23,N
1645,28,vid1b,10,993,1b,6,999,23,N
1646,28,vid2,10,999,2b,11,1010,23,N
1647,28,vid3,10,1010,3b,15,1025,23,N
1648,28,vid4,10,1025,4b,16,1041,23,N
1649,28,vid5,10,1041,5,7,1048,23,N
1650,28,vid1a_q,11,1075,1b,17,1092,29,S
1651,28,vid1b_q,11,1092,1b,6,1098,29,S
1652,28,vid2_q,11,1098,2a,11,1109,29,S
1653,28,vid3_q,11,1112,3b,15,1127,29,S
1654,28,vid4_q,11,1130,4a,16,1146,29,S
1655,28,vid5_q,11,1146,5,7,1153,29,S
1656,29,vid1a_q,0,12,1b,17,29,22,S
1657,29,vid1b_q,0,29,1b,6,35,22,S
1658,29,vid2_q,0,35,2b,11,46,22,S
1659,29,vid3_q,0,49,3a,15,64,22,S
1660,29,vid4_q,0,67,4b,16,83,22,S
1661,29,vid5_q,0,83,5,7,90,22,S
1662,29,vid1a,1,111,1b,17,128,34,N
1663,29,vid1b,1,128,1b,6,134,34,N
1664,29,vid2,1,134,2a,11,145,34,N
1665,29,vid3,1,145,3a,15,160,34,N
1666,29,vid4,1,161,4a,16,177,34,N
1667,29,vid5,1,177,5,7,184,34,N
1668,29,vid1a,2,207,1b,17,224,19,N
1669,29,vid1b,2,224,1b,6,230,19,N
1670,29,vid2,2,230,2b,11,241,19,N
1671,29,vid3,2,241,3b,15,256,19,N
1672,29,vid4,2,256,4b,16,272,19,N
1673,29,vid5,2,272,5,7,279,19,N
1674,29,vid1a,3,303,1b,17,320,23,S
1675,29,vid1b,3,320,1b,6,326,23,S
1676,29,vid2,3,326,2b,11,337,23,S
1677,29,vid3,3,337,3a,15,352,23,S
1678,29,vid4,3,353,4b,16,369,23,S
1679,29,vid5,3,369,5,7,376,23,S
1680,29,vid1a,4,399,1b,17,416,6,S
1681,29,vid1b,4,416,1b,6,422,6,S
1682,29,vid2,4,422,2a,11,433,6,S
1683,29,vid3,4,433,3b,15,448,6,S
1684,29,vid4,4,449,4a,16,465,6,S
1685,29,vid5,4,465,5,7,472,6,S
1686,29,vid1a,5,495,1b,17,512,2,N
1687,29,vid1b,5,512,1b,6,518,2,N
1688,29,vid2,5,518,2a,11,529,2,N
1689,29,vid3,5,530,3a,15,545,2,N
1690,29,vid4,5,545,4a,16,561,2,N
1691,29,vid5,5,561,5,7,568,2,N
1692,29,vid1a,6,592,1b,17,609,28,N
1693,29,vid1b,6,608,1b,6,614,28,N
1694,29,vid2,6,614,2a,11,625,28,N
1695,29,vid3,6,626,3a,15,641,28,N
1696,29,vid4,6,641,4a,16,657,28,N
1697,29,vid5,6,657,5,7,664,28,N
1698,29,vid1a,7,688,1b,17,705,20,S
1699,29,vid1b,7,705,1b,6,711,20,S
1700,29,vid2,7,711,2b,11,722,20,S
1701,29,vid3,7,722,3a,15,737,20,S
1702,29,vid4,7,738,4b,16,754,20,S
1703,29,vid5,7,754,5,7,761,20,S
1704,29,vid1a,8,784,1b,17,801,1,S
1705,29,vid1b,8,800,1b,6,806,1,S
1706,29,vid2,8,806,2a,11,817,1,S
1707,29,vid3,8,818,3b,15,833,1,S
1708,29,vid4,8,833,4a,16,849,1,S
1709,29,vid5,8,849,5,7,856,1,S
1710,29,vid1a,9,880,1b,17,897,38,N
1711,29,vid1b,9,897,1b,6,903,38,N
1712,29,vid2,9,903,2b,11,914,38,N
1713,29,vid3,9,914,3b,15,929,38,N
1714,29,vid4,9,929,4b,16,945,38,N
1715,29,vid5,9,945,5,7,952,38,N
1716,29,vid1a,10,976,1b,17,993,17,N
1717,29,vid1b,10,993,1b,6,999,17,N
1718,29,vid2,10,999,2b,11,1010,17,N
1719,29,vid3,10,1010,3b,15,1025,17,N
1720,29,vid4,10,1026,4b,16,1042,17,N
1721,29,vid5,10,1042,5,7,1049,17,N
1722,29,vid1a_q,11,1075,1b,17,1092,29,S
1723,29,vid1b_q,11,1092,1b,6,1098,29,S
1724,29,vid2_q,11,1098,2a,11,1109,29,S
1725,29,vid3_q,11,1112,3b,15,1127,29,S
1726,29,vid4_q,11,1130,4a,16,1146,29,S
1727,29,vid5_q,11,1146,5,7,1153,29,S
1728,30,vid1a_q,0,12,1b,17,29,38,S
1729,30,vid1b_q,0,29,1b,6,35,38,S
1730,30,vid2_q,0,35,2a,11,46,38,S
1731,30,vid3_q,0,49,3b,15,64,38,S
1732,30,vid4_q,0,67,4a,16,83,38,S
1733,30,vid5_q,0,83,5,7,90,38,S
1734,30,vid1a,1,111,1b,17,128,20,N
1735,30,vid1b,1,128,1b,6,134,20,N
1736,30,vid2,1,134,2b,11,145,20,N
1737,30,vid3,1,145,3b,15,160,20,N
1738,30,vid4,1,161,4b,16,177,20,N
1739,30,vid5,1,177,5,7,184,20,N
1740,30,vid1a,2,207,1b,17,224,17,N
1741,30,vid1b,2,223,1b,6,229,17,N
1742,30,vid2,2,229,2b,11,240,17,N
1743,30,vid3,2,241,3b,15,256,17,N
1744,30,vid4,2,256,4b,16,272,17,N
1745,30,vid5,2,272,5,7,279,17,N
1746,30,vid1a,3,303,1b,17,320,22,S
1747,30,vid1b,3,319,1b,6,325,22,S
1748,30,vid2,3,325,2a,11,336,22,S
1749,30,vid3,3,337,3b,15,352,22,S
1750,30,vid4,3,352,4a,16,368,22,S
1751,30,vid5,3,368,5,7,375,22,S
1752,30,vid1a,4,398,1b,17,415,28,S
1753,30,vid1b,4,415,1b,6,421,28,S
1754,30,vid2,4,421,2b,11,432,28,S
1755,30,vid3,4,432,3a,15,447,28,S
1756,30,vid4,4,448,4b,16,464,28,S
1757,30,vid5,4,464,5,7,471,28,S
1758,30,vid1a,5,495,1b,17,512,1,N
1759,30,vid1b,5,511,1b,6,517,1,N
1760,30,vid2,5,517,2a,11,528,1,N
1761,30,vid3,5,529,3a,15,544,1,N
1762,30,vid4,5,544,4a,16,560,1,N
1763,30,vid5,5,560,5,7,567,1,N
1764,30,vid1a,6,591,1b,17,608,34,N
1765,30,vid1b,6,607,1b,6,613,34,N
1766,30,vid2,6,613,2a,11,624,34,N
1767,30,vid3,6,625,3a,15,640,34,N
1768,30,vid4,6,640,4a,16,656,34,N
1769,30,vid5,6,656,5,7,663,34,N
1770,30,vid1a,7,687,1b,17,704,2,S
1771,30,vid1b,7,703,1b,6,709,2,S
1772,30,vid2,7,709,2b,11,720,2,S
1773,30,vid3,7,721,3a,15,736,2,S
1774,30,vid4,7,736,4b,16,752,2,S
1775,30,vid5,7,752,5,7,759,2,S
1776,30,vid1a,8,783,1b,17,800,29,S
1777,30,vid1b,8,800,1b,6,806,29,S
1778,30,vid2,8,806,2a,11,817,29,S
1779,30,vid3,8,817,3b,15,832,29,S
1780,30,vid4,8,832,4a,16,848,29,S
1781,30,vid5,8,848,5,7,855,29,S
1782,30,vid1a,9,879,1b,17,896,23,N
1783,30,vid1b,9,896,1b,6,902,23,N
1784,30,vid2,9,902,2a,11,913,23,N
1785,30,vid3,9,913,3a,15,928,23,N
1786,30,vid4,9,928,4a,16,944,23,N
1787,30,vid5,9,944,5,7,951,23,N
1788,30,vid1a,10,976,1b,17,993,19,N
1789,30,vid1b,10,992,1b,6,998,19,N
1790,30,vid2,10,998,2b,11,1009,19,N
1791,30,vid3,10,1010,3b,15,1025,19,N
1792,30,vid4,10,1025,4b,16,1041,19,N
1793,30,vid5,10,1041,5,7,1048,19,N
1794,30,vid1a_q,11,1075,1b,17,1092,6,S
1795,30,vid1b_q,11,1091,1b,6,1097,6,S
1796,30,vid2_q,11,1097,2b,11,1108,6,S
1797,30,vid3_q,11,1111,3a,15,1126,6,S
1798,30,vid4_q,11,1129,4b,16,1145,6,S
1799,30,vid5_q,11,1145,5,7,1152,6,S
1800,31,vid1a_q,0,12,1b,17,29,17,S
1801,31,vid1b_q,0,29,1b,6,35,17,S
1802,31,vid2_q,0,35,2b,11,46,17,S
1803,31,vid3_q,0,49,3a,15,64,17,S
1804,31,vid4_q,0,67,4b,16,83,17,S
1805,31,vid5_q,0,83,5,7,90,17,S
1806,31,vid1a,1,111,1b,17,128,2,N
1807,31,vid1b,1,128,1b,6,134,2,N
1808,31,vid2,1,134,2b,11,145,2,N
1809,31,vid3,1,145,3b,15,160,2,N
1810,31,vid4,1,161,4b,16,177,2,N
1811,31,vid5,1,177,5,7,184,2,N
1812,31,vid1a,2,207,1b,17,224,29,N
1813,31,vid1b,2,224,1b,6,230,29,N
1814,31,vid2,2,230,2a,11,241,29,N
1815,31,vid3,2,241,3a,15,256,29,N
1816,31,vid4,2,257,4a,16,273,29,N
1817,31,vid5,2,273,5,7,280,29,N
1818,31,vid1a,3,303,1b,17,320,38,S
1819,31,vid1b,3,320,1b,6,326,38,S
1820,31,vid2,3,326,2a,11,337,38,S
1821,31,vid3,3,337,3b,15,352,38,S
1822,31,vid4,3,352,4a,16,368,38,S
1823,31,vid5,3,368,5,7,375,38,S
1824,31,vid1a,4,399,1b,17,416,1,S
1825,31,vid1b,4,416,1b,6,422,1,S
1826,31,vid2,4,422,2b,11,433,1,S
1827,31,vid3,4,433,3a,15,448,1,S
1828,31,vid4,4,448,4b,16,464,1,S
1829,31,vid5,4,464,5,7,471,1,S
1830,31,vid1a,5,495,1b,17,512,22,N
1831,31,vid1b,5,512,1b,6,518,22,N
1832,31,vid2,5,518,2b,11,529,22,N
1833,31,vid3,5,529,3b,15,544,22,N
1834,31,vid4,5,544,4b,16,560,22,N
1835,31,vid5,5,560,5,7,567,22,N
1836,31,vid1a,6,591,1b,17,608,28,N
1837,31,vid1b,6,608,1b,6,614,28,N
1838,31,vid2,6,614,2b,11,625,28,N
1839,31,vid3,6,625,3b,15,640,28,N
1840,31,vid4,6,640,4b,16,656,28,N
1841,31,vid5,6,656,5,7,663,28,N
1842,31,vid1a,7,687,1b,17,704,20,S
1843,31,vid1b,7,704,1b,6,710,20,S
1844,31,vid2,7,710,2a,11,721,20,S
1845,31,vid3,7,721,3b,15,736,20,S
1846,31,vid4,7,737,4a,16,753,20,S
1847,31,vid5,7,753,5,7,760,20,S
1848,31,vid1a,8,783,1b,17,800,34,S
1849,31,vid1b,8,800,1b,6,806,34,S
1850,31,vid2,8,806,2a,11,817,34,S
1851,31,vid3,8,817,3b,15,832,34,S
1852,31,vid4,8,832,4a,16,848,34,S
1853,31,vid5,8,848,5,7,855,34,S
1854,31,vid1a,9,879,1b,17,896,19,N
1855,31,vid1b,9,896,1b,6,902,19,N
1856,31,vid2,9,902,2a,11,913,19,N
1857,31,vid3,9,913,3a,15,928,19,N
1858,31,vid4,9,929,4a,16,945,19,N
1859,31,vid5,9,945,5,7,952,19,N
1860,31,vid1a,10,976,1b,17,993,23,N
1861,31,vid1b,10,993,1b,6,999,23,N
1862,31,vid2,10,999,2a,11,1010,23,N
1863,31,vid3,10,1010,3a,15,1025,23,N
1864,31,vid4,10,1025,4a,16,1041,23,N
1865,31,vid5,10,1041,5,7,1048,23,N
1866,31,vid1a_q,11,1075,1b,17,1092,6,S
1867,31,vid1b_q,11,1091,1b,6,1097,6,S
1868,31,vid2_q,11,1097,2b,11,1108,6,S
1869,31,vid3_q,11,1111,3a,15,1126,6,S
1870,31,vid4_q,11,1129,4b,16,1145,6,S
1871,31,vid5_q,11,1145,5,7,1152,6,S
1872,32,vid1a_q,0,12,1b,17,29,29,S
1873,32,vid1b_q,0,29,1b,6,35,29,S
1874,32,vid2_q,0,35,2a,11,46,29,S
1875,32,vid3_q,0,49,3b,15,64,29,S
1876,32,vid4_q,0,67,4a,16,83,29,S
1877,32,vid5_q,0,83,5,7,90,29,S
1878,32,vid1a,1,111,1b,17,128,34,N
1879,32,vid1b,1,128,1b,6,134,34,N
1880,32,vid2,1,134,2a,11,145,34,N
1881,32,vid3,1,145,3a,15,160,34,N
1882,32,vid4,1,161,4a,16,177,34,N
1883,32,vid5,1,177,5,7,184,34,N
1884,32,vid1a,2,207,1b,17,224,17,N
1885,32,vid1b,2,224,1b,6,230,17,N
1886,32,vid2,2,230,2a,11,241,17,N
1887,32,vid3,2,241,3a,15,256,17,N
1888,32,vid4,2,256,4a,16,272,17,N
1889,32,vid5,2,272,5,7,279,17,N
1890,32,vid1a,3,303,1b,17,320,20,S
1891,32,vid1b,3,319,1b,6,325,20,S
1892,32,vid2,3,325,2b,11,336,20,S
1893,32,vid3,3,337,3a,15,352,20,S
1894,32,vid4,3,352,4b,16,368,20,S
1895,32,vid5,3,368,5,7,375,20,S
1896,32,vid1a,4,398,1b,17,415,2,S
1897,32,vid1b,4,415,1b,6,421,2,S
1898,32,vid2,4,421,2b,11,432,2,S
1899,32,vid3,4,432,3a,15,447,2,S
1900,32,vid4,4,447,4b,16,463,2,S
1901,32,vid5,4,463,5,7,470,2,S
1902,32,vid1a,5,494,1b,17,511,19,N
1903,32,vid1b,5,511,1b,6,517,19,N
1904,32,vid2,5,517,2b,11,528,19,N
1905,32,vid3,5,528,3b,15,543,19,N
1906,32,vid4,5,543,4b,16,559,19,N
1907,32,vid5,5,559,5,7,566,19,N
1908,32,vid1a,6,590,1b,17,607,23,N
1909,32,vid1b,6,607,1b,6,613,23,N
1910,32,vid2,6,613,2a,11,624,23,N
1911,32,vid3,6,624,3a,15,639,23,N
1912,32,vid4,6,640,4a,16,656,23,N
1913,32,vid5,6,656,5,7,663,23,N
1914,32,vid1a,7,687,1b,17,704,38,S
1915,32,vid1b,7,704,1b,6,710,38,S
1916,32,vid2,7,710,2a,11,721,38,S
1917,32,vid3,7,721,3b,15,736,38,S
1918,32,vid4,7,736,4a,16,752,38,S
1919,32,vid5,7,752,5,7,759,38,S
1920,32,vid1a,8,783,1b,17,800,6,S
1921,32,vid1b,8,800,1b,6,806,6,S
1922,32,vid2,8,806,2a,11,817,6,S
1923,32,vid3,8,817,3b,15,832,6,S
1924,32,vid4,8,833,4a,16,849,6,S
1925,32,vid5,8,849,5,7,856,6,S
1926,32,vid1a,9,880,1b,17,897,28,N
1927,32,vid1b,9,896,1b,6,902,28,N
1928,32,vid2,9,902,2b,11,913,28,N
1929,32,vid3,9,914,3b,15,929,28,N
1930,32,vid4,9,929,4b,16,945,28,N
1931,32,vid5,9,945,5,7,952,28,N
1932,32,vid1a,10,976,1b,17,993,1,N
1933,32,vid1b,10,993,1b,6,999,1,N
1934,32,vid2,10,999,2b,11,1010,1,N
1935,32,vid3,10,1010,3b,15,1025,1,N
1936,32,vid4,10,1026,4b,16,1042,1,N
1937,32,vid5,10,1042,5,7,1049,1,N
1938,32,vid1a_q,11,1075,1b,17,1092,22,S
1939,32,vid1b_q,11,1092,1b,6,1098,22,S
1940,32,vid2_q,11,1098,2b,11,1109,22,S
1941,32,vid3_q,11,1112,3a,15,1127,22,S
1942,32,vid4_q,11,1130,4b,16,1146,22,S
1943,32,vid5_q,11,1146,5,7,1153,22,S
1944,33,vid1a_q,0,12,1b,17,29,23,S
1945,33,vid1b_q,0,29,1b,6,35,23,S
1946,33,vid2_q,0,35,2b,11,46,23,S
1947,33,vid3_q,0,49,3a,15,64,23,S
1948,33,vid4_q,0,67,4b,16,83,23,S
1949,33,vid5_q,0,83,5,7,90,23,S
1950,33,vid1a,1,112,1b,17,129,1,N
1951,33,vid1b,1,128,1b,6,134,1,N
1952,33,vid2,1,134,2a,11,145,1,N
1953,33,vid3,1,146,3a,15,161,1,N
1954,33,vid4,1,161,4a,16,177,1,N
1955,33,vid5,1,177,5,7,184,1,N
1956,33,vid1a,2,207,1b,17,224,28,N
1957,33,vid1b,2,224,1b,6,230,28,N
1958,33,vid2,2,230,2a,11,241,28,N
1959,33,vid3,2,242,3a,15,257,28,N
1960,33,vid4,2,257,4a,16,273,28,N
1961,33,vid5,2,273,5,7,280,28,N
1962,33,vid1a,3,304,1b,17,321,34,S
1963,33,vid1b,3,320,1b,6,326,34,S
1964,33,vid2,3,326,2a,11,337,34,S
1965,33,vid3,3,338,3b,15,353,34,S
1966,33,vid4,3,353,4a,16,369,34,S
1967,33,vid5,3,369,5,7,376,34,S
1968,33,vid1a,4,400,1b,17,417,6,S
1969,33,vid1b,4,416,1b,6,422,6,S
1970,33,vid2,4,422,2a,11,433,6,S
1971,33,vid3,4,434,3b,15,449,6,S
1972,33,vid4,4,449,4a,16,465,6,S
1973,33,vid5,4,465,5,7,472,6,S
1974,33,vid1a,5,496,1b,17,513,20,N
1975,33,vid1b,5,512,1b,6,518,20,N
1976,33,vid2,5,518,2b,11,529,20,N
1977,33,vid3,5,530,3b,15,545,20,N
1978,33,vid4,5,545,4b,16,561,20,N
1979,33,vid5,5,561,5,7,568,20,N
1980,33,vid1a,6,591,1b,17,608,2,N
1981,33,vid1b,6,608,1b,6,614,2,N
1982,33,vid2,6,614,2a,11,625,2,N
1983,33,vid3,6,625,3a,15,640,2,N
1984,33,vid4,6,640,4a,16,656,2,N
1985,33,vid5,6,656,5,7,663,2,N
1986,33,vid1a,7,687,1b,17,704,17,S
1987,33,vid1b,7,704,1b,6,710,17,S
1988,33,vid2,7,710,2a,11,721,17,S
1989,33,vid3,7,721,3b,15,736,17,S
1990,33,vid4,7,737,4a,16,753,17,S
1991,33,vid5,7,753,5,7,760,17,S
1992,33,vid1a,8,784,1b,17,801,22,S
1993,33,vid1b,8,800,1b,6,806,22,S
1994,33,vid2,8,806,2b,11,817,22,S
1995,33,vid3,8,818,3a,15,833,22,S
1996,33,vid4,8,833,4b,16,849,22,S
1997,33,vid5,8,849,5,7,856,22,S
1998,33,vid1a,9,880,1b,17,897,38,N
1999,33,vid1b,9,897,1b,6,903,38,N
2000,33,vid2,9,903,2b,11,914,38,N
2001,33,vid3,9,914,3b,15,929,38,N
2002,33,vid4,9,929,4b,16,945,38,N
2003,33,vid5,9,945,5,7,952,38,N
2004,33,vid1a,10,976,1b,17,993,29,N
2005,33,vid1b,10,993,1b,6,999,29,N
2006,33,vid2,10,999,2b,11,1010,29,N
2007,33,vid3,10,1010,3b,15,1025,29,N
2008,33,vid4,10,1026,4b,16,1042,29,N
2009,33,vid5,10,1042,5,7,1049,29,N
2010,33,vid1a_q,11,1075,1b,17,1092,19,S
2011,33,vid1b_q,11,1091,1b,6,1097,19,S
2012,33,vid2_q,11,1097,2b,11,1108,19,S
2013,33,vid3_q,11,1111,3a,15,1126,19,S
2014,33,vid4_q,11,1129,4b,16,1145,19,S
2015,33,vid5_q,11,1145,5,7,1152,19,S
2016,34,vid1a_q,0,13,1b,17,30,28,S
2017,34,vid1b_q,0,29,1b,6,35,28,S
2018,34,vid2_q,0,35,2a,11,46,28,S
2019,34,vid3_q,0,49,3b,15,64,28,S
2020,34,vid4_q,0,67,4a,16,83,28,S
2021,34,vid5_q,0,83,5,7,90,28,S
2022,34,vid1a,1,112,1b,17,129,6,N
2023,34,vid1b,1,129,1b,6,135,6,N
2024,34,vid2,1,135,2a,11,146,6,N
2025,34,vid3,1,146,3a,15,161,6,N
2026,34,vid4,1,162,4a,16,178,6,N
2027,34,vid5,1,178,5,7,185,6,N
2028,34,vid1a,2,208,1b,17,225,1,N
2029,34,vid1b,2,225,1b,6,231,1,N
2030,34,vid2,2,231,2b,11,242,1,N
2031,34,vid3,2,242,3b,15,257,1,N
2032,34,vid4,2,258,4b,16,274,1,N
2033,34,vid5,2,274,5,7,281,1,N
2034,34,vid1a,3,304,1b,17,321,20,S
2035,34,vid1b,3,321,1b,6,327,20,S
2036,34,vid2,3,327,2b,11,338,20,S
2037,34,vid3,3,338,3a,15,353,20,S
2038,34,vid4,3,353,4b,16,369,20,S
2039,34,vid5,3,369,5,7,376,20,S
2040,34,vid1a,4,399,1b,17,416,22,S
2041,34,vid1b,4,416,1b,6,422,22,S
2042,34,vid2,4,422,2a,11,433,22,S
2043,34,vid3,4,433,3b,15,448,22,S
2044,34,vid4,4,449,4a,16,465,22,S
2045,34,vid5,4,465,5,7,472,22,S
2046,34,vid1a,5,495,1b,17,512,2,N
2047,34,vid1b,5,512,1b,6,518,2,N
2048,34,vid2,5,518,2a,11,529,2,N
2049,34,vid3,5,529,3a,15,544,2,N
2050,34,vid4,5,545,4a,16,561,2,N
2051,34,vid5,5,561,5,7,568,2,N
2052,34,vid1a,6,591,1b,17,608,29,N
2053,34,vid1b,6,608,1b,6,614,29,N
2054,34,vid2,6,614,2b,11,625,29,N
2055,34,vid3,6,625,3b,15,640,29,N
2056,34,vid4,6,641,4b,16,657,29,N
2057,34,vid5,6,657,5,7,664,29,N
2058,34,vid1a,7,687,1b,17,704,38,S
2059,34,vid1b,7,704,1b,6,710,38,S
2060,34,vid2,7,710,2a,11,721,38,S
2061,34,vid3,7,721,3b,15,736,38,S
2062,34,vid4,7,737,4a,16,753,38,S
2063,34,vid5,7,753,5,7,760,38,S
2064,34,vid1a,8,783,1b,17,800,34,S
2065,34,vid1b,8,800,1b,6,806,34,S
2066,34,vid2,8,806,2b,11,817,34,S
2067,34,vid3,8,818,3a,15,833,34,S
2068,34,vid4,8,833,4b,16,849,34,S
2069,34,vid5,8,849,5,7,856,34,S
2070,34,vid1a,9,880,1b,17,897,19,N
2071,34,vid1b,9,896,1b,6,902,19,N
2072,34,vid2,9,902,2a,11,913,19,N
2073,34,vid3,9,914,3a,15,929,19,N
2074,34,vid4,9,929,4a,16,945,19,N
2075,34,vid5,9,945,5,7,952,19,N
2076,34,vid1a,10,976,1b,17,993,17,N
2077,34,vid1b,10,993,1b,6,999,17,N
2078,34,vid2,10,999,2b,11,1010,17,N
2079,34,vid3,10,1010,3b,15,1025,17,N
2080,34,vid4,10,1026,4b,16,1042,17,N
2081,34,vid5,10,1042,5,7,1049,17,N
2082,34,vid1a_q,11,1075,1b,17,1092,23,S
2083,34,vid1b_q,11,1092,1b,6,1098,23,S
2084,34,vid2_q,11,1098,2b,11,1109,23,S
2085,34,vid3_q,11,1112,3a,15,1127,23,S
2086,34,vid4_q,11,1130,4b,16,1146,23,S
2087,34,vid5_q,11,1146,5,7,1153,23,S
2088,35,vid1a_q,0,12,1b,17,29,1,S
2089,35,vid1b_q,0,29,1b,6,35,1,S
2090,35,vid2_q,0,35,2a,11,46,1,S
2091,35,vid3_q,0,49,3b,15,64,1,S
2092,35,vid4_q,0,67,4a,16,83,1,S
2093,35,vid5_q,0,83,5,7,90,1,S
2094,35,vid1a,1,111,1b,17,128,23,N
2095,35,vid1b,1,128,1b,6,134,23,N
2096,35,vid2,1,134,2a,11,145,23,N
2097,35,vid3,1,145,3a,15,160,23,N
2098,35,vid4,1,161,4a,16,177,23,N
2099,35,vid5,1,177,5,7,184,23,N
2100,35,vid1a,2,208,1b,17,225,29,N
2101,35,vid1b,2,224,1b,6,230,29,N
2102,35,vid2,2,230,2b,11,241,29,N
2103,35,vid3,2,242,3b,15,257,29,N
2104,35,vid4,2,257,4b,16,273,29,N
2105,35,vid5,2,273,5,7,280,29,N
2106,35,vid1a,3,303,1b,17,320,2,S
2107,35,vid1b,3,320,1b,6,326,2,S
2108,35,vid2,3,326,2b,11,337,2,S
2109,35,vid3,3,337,3a,15,352,2,S
2110,35,vid4,3,353,4b,16,369,2,S
2111,35,vid5,3,369,5,7,376,2,S
2112,35,vid1a,4,399,1b,17,416,6,S
2113,35,vid1b,4,416,1b,6,422,6,S
2114,35,vid2,4,422,2a,11,433,6,S
2115,35,vid3,4,433,3b,15,448,6,S
2116,35,vid4,4,449,4a,16,465,6,S
2117,35,vid5,4,465,5,7,472,6,S
2118,35,vid1a,5,496,1b,17,513,38,N
2119,35,vid1b,5,512,1b,6,518,38,N
2120,35,vid2,5,518,2a,11,529,38,N
2121,35,vid3,5,530,3a,15,545,38,N
2122,35,vid4,5,545,4a,16,561,38,N
2123,35,vid5,5,561,5,7,568,38,N
2124,35,vid1a,6,592,1b,17,609,17,N
2125,35,vid1b,6,609,1b,6,615,17,N
2126,35,vid2,6,615,2a,11,626,17,N
2127,35,vid3,6,626,3a,15,641,17,N
2128,35,vid4,6,641,4a,16,657,17,N
2129,35,vid5,6,657,5,7,664,17,N
2130,35,vid1a,7,688,1b,17,705,19,S
2131,35,vid1b,7,705,1b,6,711,19,S
2132,35,vid2,7,711,2a,11,722,19,S
2133,35,vid3,7,722,3b,15,737,19,S
2134,35,vid4,7,737,4a,16,753,19,S
2135,35,vid5,7,753,5,7,760,19,S
2136,35,vid1a,8,785,1b,17,802,22,S
2137,35,vid1b,8,801,1b,6,807,22,S
2138,35,vid2,8,807,2b,11,818,22,S
2139,35,vid3,8,819,3a,15,834,22,S
2140,35,vid4,8,834,4b,16,850,22,S
2141,35,vid5,8,850,5,7,857,22,S
2142,35,vid1a,9,881,1b,17,898,28,N
2143,35,vid1b,9,898,1b,6,904,28,N
2144,35,vid2,9,904,2b,11,915,28,N
2145,35,vid3,9,915,3b,15,930,28,N
2146,35,vid4,9,930,4b,16,946,28,N
2147,35,vid5,9,946,5,7,953,28,N
2148,35,vid1a,10,978,1b,17,995,34,N
2149,35,vid1b,10,994,1b,6,1000,34,N
2150,35,vid2,10,1000,2b,11,1011,34,N
2151,35,vid3,10,1012,3b,15,1027,34,N
2152,35,vid4,10,1027,4b,16,1043,34,N
2153,35,vid5,10,1043,5,7,1050,34,N
2154,35,vid1a_q,11,1076,1b,17,1093,20,S
2155,35,vid1b_q,11,1093,1b,6,1099,20,S
2156,35,vid2_q,11,1099,2b,11,1110,20,S
2157,35,vid3_q,11,1113,3a,15,1128,20,S
2158,35,vid4_q,11,1131,4b,16,1147,20,S
2159,35,vid5_q,11,1147,5,7,1154,20,S
2160,36,vid1a_q,0,12,1b,17,29,2,S
2161,36,vid1b_q,0,29,1b,6,35,2,S
2162,36,vid2_q,0,35,2b,11,46,2,S
2163,36,vid3_q,0,49,3a,15,64,2,S
2164,36,vid4_q,0,67,4b,16,83,2,S
2165,36,vid5_q,0,83,5,7,90,2,S
2166,36,vid1a,1,111,1b,17,128,17,N
2167,36,vid1b,1,128,1b,6,134,17,N
2168,36,vid2,1,134,2b,11,145,17,N
2169,36,vid3,1,145,3b,15,160,17,N
2170,36,vid4,1,161,4b,16,177,17,N
2171,36,vid5,1,177,5,7,184,17,N
2172,36,vid1a,2,207,1b,17,224,1,N
2173,36,vid1b,2,224,1b,6,230,1,N
2174,36,vid2,2,230,2b,11,241,1,N
2175,36,vid3,2,241,3b,15,256,1,N
2176,36,vid4,2,257,4b,16,273,1,N
2177,36,vid5,2,273,5,7,280,1,N
2178,36,vid1a,3,303,1b,17,320,6,S
2179,36,vid1b,3,320,1b,6,326,6,S
2180,36,vid2,3,326,2a,11,337,6,S
2181,36,vid3,3,337,3b,15,352,6,S
2182,36,vid4,3,352,4a,16,368,6,S
2183,36,vid5,3,368,5,7,375,6,S
2184,36,vid1a,4,399,1b,17,416,23,S
2185,36,vid1b,4,416,1b,6,422,23,S
2186,36,vid2,4,422,2b,11,433,23,S
2187,36,vid3,4,433,3a,15,448,23,S
2188,36,vid4,4,448,4b,16,464,23,S
2189,36,vid5,4,464,5,7,471,23,S
2190,36,vid1a,5,496,1b,17,513,19,N
2191,36,vid1b,5,512,1b,6,518,19,N
2192,36,vid2,5,518,2b,11,529,19,N
2193,36,vid3,5,529,3b,15,544,19,N
2194,36,vid4,5,545,4b,16,561,19,N
2195,36,vid5,5,561,5,7,568,19,N
2196,36,vid1a,6,592,1b,17,609,28,N
2197,36,vid1b,6,609,1b,6,615,28,N
2198,36,vid2,6,615,2a,11,626,28,N
2199,36,vid3,6,626,3a,15,641,28,N
2200,36,vid4,6,641,4a,16,657,28,N
2201,36,vid5,6,657,5,7,664,28,N
2202,36,vid1a,7,689,1b,17,706,22,S
2203,36,vid1b,7,705,1b,6,711,22,S
2204,36,vid2,7,711,2a,11,722,22,S
2205,36,vid3,7,723,3b,15,738,22,S
2206,36,vid4,7,738,4a,16,754,22,S
2207,36,vid5,7,754,5,7,761,22,S
2208,36,vid1a,8,785,1b,17,802,34,S
2209,36,vid1b,8,801,1b,6,807,34,S
2210,36,vid2,8,807,2b,11,818,34,S
2211,36,vid3,8,819,3a,15,834,34,S
2212,36,vid4,8,834,4b,16,850,34,S
2213,36,vid5,8,850,5,7,857,34,S
2214,36,vid1a,9,881,1b,17,898,38,N
2215,36,vid1b,9,897,1b,6,903,38,N
2216,36,vid2,9,903,2a,11,914,38,N
2217,36,vid3,9,915,3a,15,930,38,N
2218,36,vid4,9,930,4a,16,946,38,N
2219,36,vid5,9,946,5,7,953,38,N
2220,36,vid1a,10,977,1b,17,994,29,N
2221,36,vid1b,10,994,1b,6,1000,29,N
2222,36,vid2,10,1000,2a,11,1011,29,N
2223,36,vid3,10,1011,3a,15,1026,29,N
2224,36,vid4,10,1027,4a,16,1043,29,N
2225,36,vid5,10,1043,5,7,1050,29,N
2226,36,vid1a_q,11,1076,1b,17,1093,20,S
2227,36,vid1b_q,11,1092,1b,6,1098,20,S
2228,36,vid2_q,11,1098,2a,11,1109,20,S
2229,36,vid3_q,11,1112,3b,15,1127,20,S
2230,36,vid4_q,11,1130,4a,16,1146,20,S
2231,36,vid5_q,11,1146,5,7,1153,20,S
2232,38,vid1a_q,0,12,1b,17,29,23,S
2233,38,vid1b_q,0,29,1b,6,35,23,S
2234,38,vid2_q,0,35,2b,11,46,23,S
2235,38,vid3_q,0,49,3a,15,64,23,S
2236,38,vid4_q,0,67,4b,16,83,23,S
2237,38,vid5_q,0,83,5,7,90,23,S
2238,38,vid1a,1,112,1b,17,129,29,N
2239,38,vid1b,1,128,1b,6,134,29,N
2240,38,vid2,1,134,2b,11,145,29,N
2241,38,vid3,1,146,3b,15,161,29,N
2242,38,vid4,1,161,4b,16,177,29,N
2243,38,vid5,1,177,5,7,184,29,N
2244,38,vid1a,2,207,1b,17,224,1,N
2245,38,vid1b,2,224,1b,6,230,1,N
2246,38,vid2,2,230,2b,11,241,1,N
2247,38,vid3,2,241,3b,15,256,1,N
2248,38,vid4,2,257,4b,16,273,1,N
2249,38,vid5,2,273,5,7,280,1,N
2250,38,vid1a,3,303,1b,17,320,22,S
2251,38,vid1b,3,320,1b,6,326,22,S
2252,38,vid2,3,326,2a,11,337,22,S
2253,38,vid3,3,337,3b,15,352,22,S
2254,38,vid4,3,353,4a,16,369,22,S
2255,38,vid5,3,369,5,7,376,22,S
2256,38,vid1a,4,399,1b,17,416,2,S
2257,38,vid1b,4,416,1b,6,422,2,S
2258,38,vid2,4,422,2a,11,433,2,S
2259,38,vid3,4,433,3b,15,448,2,S
2260,38,vid4,4,448,4a,16,464,2,S
2261,38,vid5,4,465,5,7,472,2,S
2262,38,vid1a,5,495,1b,17,512,19,N
2263,38,vid1b,5,512,1b,6,518,19,N
2264,38,vid2,5,518,2b,11,529,19,N
2265,38,vid3,5,529,3b,15,544,19,N
2266,38,vid4,5,545,4b,16,561,19,N
2267,38,vid5,5,561,5,7,568,19,N
2268,38,vid1a,6,592,1b,17,609,17,N
2269,38,vid1b,6,609,1b,6,615,17,N
2270,38,vid2,6,615,2a,11,626,17,N
2271,38,vid3,6,626,3a,15,641,17,N
2272,38,vid4,6,641,4a,16,657,17,N
2273,38,vid5,6,657,5,7,664,17,N
2274,38,vid1a,7,688,1b,17,705,38,S
2275,38,vid1b,7,705,1b,6,711,38,S
2276,38,vid2,7,711,2b,11,722,38,S
2277,38,vid3,7,722,3a,15,737,38,S
2278,38,vid4,7,737,4b,16,753,38,S
2279,38,vid5,7,753,5,7,760,38,S
2280,38,vid1a,8,784,1b,17,801,20,S
2281,38,vid1b,8,801,1b,6,807,20,S
2282,38,vid2,8,807,2a,11,818,20,S
2283,38,vid3,8,818,3b,15,833,20,S
2284,38,vid4,8,834,4a,16,850,20,S
2285,38,vid5,8,850,5,7,857,20,S
2286,38,vid1a,9,880,1b,17,897,6,N
2287,38,vid1b,9,897,1b,6,903,6,N
2288,38,vid2,9,903,2a,11,914,6,N
2289,38,vid3,9,914,3a,15,929,6,N
2290,38,vid4,9,929,4a,16,945,6,N
2291,38,vid5,9,945,5,7,952,6,N
2292,38,vid1a,10,977,1b,17,994,28,N
2293,38,vid1b,10,993,1b,6,999,28,N
2294,38,vid2,10,999,2a,11,1010,28,N
2295,38,vid3,10,1010,3a,15,1025,28,N
2296,38,vid4,10,1026,4a,16,1042,28,N
2297,38,vid5,10,1042,5,7,1049,28,N
2298,38,vid1a_q,11,1075,1b,17,1092,34,S
2299,38,vid1b_q,11,1092,1b,6,1098,34,S
2300,38,vid2_q,11,1098,2b,11,1109,34,S
2301,38,vid3_q,11,1112,3a,15,1127,34,S
2302,38,vid4_q,11,1130,4b,16,1146,34,S
2303,38,vid5_q,11,1146,5,7,1153,34,S
2304,40,vid1a_q,0,13,1b,17,30,6,S
2305,40,vid1b_q,0,29,1b,6,35,6,S
2306,40,vid2_q,0,35,2a,11,46,6,S
2307,40,vid3_q,0,49,3b,15,64,6,S
2308,40,vid4_q,0,67,4a,16,83,6,S
2309,40,vid5_q,0,83,5,7,90,6,S
2310,40,vid1a,1,112,1b,17,129,1,N
2311,40,vid1b,1,129,1b,6,135,1,N
2312,40,vid2,1,135,2a,11,146,1,N
2313,40,vid3,1,146,3a,15,161,1,N
2314,40,vid4,1,161,4a,16,177,1,N
2315,40,vid5,1,177,5,7,184,1,N
2316,40,vid1a,2,208,1b,17,225,28,N
2317,40,vid1b,2,224,1b,6,230,28,N
2318,40,vid2,2,230,2b,11,241,28,N
2319,40,vid3,2,242,3b,15,257,28,N
2320,40,vid4,2,257,4b,16,273,28,N
2321,40,vid5,2,273,5,7,280,28,N
2322,40,vid1a,3,304,1b,17,321,22,S
2323,40,vid1b,3,321,1b,6,327,22,S
2324,40,vid2,3,327,2b,11,338,22,S
2325,40,vid3,3,338,3a,15,353,22,S
2326,40,vid4,3,353,4b,16,369,22,S
2327,40,vid5,3,369,5,7,376,22,S
2328,40,vid1a,4,400,1b,17,417,17,S
2329,40,vid1b,4,417,1b,6,423,17,S
2330,40,vid2,4,423,2a,11,434,17,S
2331,40,vid3,4,434,3b,15,449,17,S
2332,40,vid4,4,449,4a,16,465,17,S
2333,40,vid5,4,465,5,7,472,17,S
2334,40,vid1a,5,496,1b,17,513,29,N
2335,40,vid1b,5,513,1b,6,519,29,N
2336,40,vid2,5,519,2b,11,530,29,N
2337,40,vid3,5,530,3b,15,545,29,N
2338,40,vid4,5,545,4b,16,561,29,N
2339,40,vid5,5,561,5,7,568,29,N
2340,40,vid1a,6,592,1b,17,609,2,N
2341,40,vid1b,6,609,1b,6,615,2,N
2342,40,vid2,6,615,2a,11,626,2,N
2343,40,vid3,6,626,3a,15,641,2,N
2344,40,vid4,6,641,4a,16,657,2,N
2345,40,vid5,6,657,5,7,664,2,N
2346,40,vid1a,7,688,1b,17,705,23,S
2347,40,vid1b,7,705,1b,6,711,23,S
2348,40,vid2,7,711,2b,11,722,23,S
2349,40,vid3,7,722,3a,15,737,23,S
2350,40,vid4,7,737,4b,16,753,23,S
2351,40,vid5,7,753,5,7,760,23,S
2352,40,vid1a,8,785,1b,17,802,20,S
2353,40,vid1b,8,801,1b,6,807,20,S
2354,40,vid2,8,807,2a,11,818,20,S
2355,40,vid3,8,819,3b,15,834,20,S
2356,40,vid4,8,834,4a,16,850,20,S
2357,40,vid5,8,850,5,7,857,20,S
2358,40,vid1a,9,880,1b,17,897,34,N
2359,40,vid1b,9,897,1b,6,903,34,N
2360,40,vid2,9,903,2a,11,914,34,N
2361,40,vid3,9,914,3a,15,929,34,N
2362,40,vid4,9,930,4a,16,946,34,N
2363,40,vid5,9,946,5,7,953,34,N
2364,40,vid1a,10,976,1b,17,993,38,N
2365,40,vid1b,10,993,1b,6,999,38,N
2366,40,vid2,10,999,2b,11,1010,38,N
2367,40,vid3,10,1011,3b,15,1026,38,N
2368,40,vid4,10,1026,4b,16,1042,38,N
2369,40,vid5,10,1042,5,7,1049,38,N
2370,40,vid1a_q,11,1075,1b,17,1092,19,S
2371,40,vid1b_q,11,1092,1b,6,1098,19,S
2372,40,vid2_q,11,1098,2b,11,1109,19,S
2373,40,vid3_q,11,1112,3a,15,1127,19,S
2374,40,vid4_q,11,1130,4b,16,1146,19,S
2375,40,vid5_q,11,1146,5,7,1153,19,S
2376,41,vid1a_q,0,12,1b,17,29,17,S
2377,41,vid1b_q,0,29,1b,6,35,17,S
2378,41,vid2_q,0,35,2a,11,46,17,S
2379,41,vid3_q,0,49,3b,15,64,17,S
2380,41,vid4_q,0,67,4a,16,83,17,S
2381,41,vid5_q,0,83,5,7,90,17,S
2382,41,vid1a,1,111,1b,17,128,6,N
2383,41,vid1b,1,128,1b,6,134,6,N
2384,41,vid2,1,134,2a,11,145,6,N
2385,41,vid3,1,145,3a,15,160,6,N
2386,41,vid4,1,161,4a,16,177,6,N
2387,41,vid5,1,177,5,7,184,6,N
2388,41,vid1a,2,207,1b,17,224,22,N
2389,41,vid1b,2,224,1b,6,230,22,N
2390,41,vid2,2,230,2b,11,241,22,N
2391,41,vid3,2,241,3b,15,256,22,N
2392,41,vid4,2,257,4b,16,273,22,N
2393,41,vid5,2,273,5,7,280,22,N
2394,41,vid1a,3,303,1b,17,320,34,S
2395,41,vid1b,3,320,1b,6,326,34,S
2396,41,vid2,3,326,2b,11,337,34,S
2397,41,vid3,3,337,3a,15,352,34,S
2398,41,vid4,3,353,4b,16,369,34,S
2399,41,vid5,3,369,5,7,376,34,S
2400,41,vid1a,4,399,1b,17,416,38,S
2401,41,vid1b,4,416,1b,6,422,38,S
2402,41,vid2,4,422,2a,11,433,38,S
2403,41,vid3,4,433,3b,15,448,38,S
2404,41,vid4,4,448,4a,16,464,38,S
2405,41,vid5,4,464,5,7,471,38,S
2406,41,vid1a,5,495,1b,17,512,1,N
2407,41,vid1b,5,512,1b,6,518,1,N
2408,41,vid2,5,518,2a,11,529,1,N
2409,41,vid3,5,529,3a,15,544,1,N
2410,41,vid4,5,545,4a,16,561,1,N
2411,41,vid5,5,561,5,7,568,1,N
2412,41,vid1a,6,591,1b,17,608,19,N
2413,41,vid1b,6,608,1b,6,614,19,N
2414,41,vid2,6,614,2b,11,625,19,N
2415,41,vid3,6,625,3b,15,640,19,N
2416,41,vid4,6,641,4b,16,657,19,N
2417,41,vid5,6,657,5,7,664,19,N
2418,41,vid1a,7,688,1b,17,705,20,S
2419,41,vid1b,7,705,1b,6,711,20,S
2420,41,vid2,7,711,2b,11,722,20,S
2421,41,vid3,7,722,3a,15,737,20,S
2422,41,vid4,7,737,4b,16,753,20,S
2423,41,vid5,7,753,5,7,760,20,S
2424,41,vid1a,8,783,1b,17,800,23,S
2425,41,vid1b,8,800,1b,6,806,23,S
2426,41,vid2,8,806,2a,11,817,23,S
2427,41,vid3,8,817,3b,15,832,23,S
2428,41,vid4,8,833,4a,16,849,23,S
2429,41,vid5,8,849,5,7,856,23,S
2430,41,vid1a,9,880,1b,17,897,29,N
2431,41,vid1b,9,897,1b,6,903,29,N
2432,41,vid2,9,903,2a,11,914,29,N
2433,41,vid3,9,914,3a,15,929,29,N
2434,41,vid4,9,929,4a,16,945,29,N
2435,41,vid5,9,945,5,7,952,29,N
2436,41,vid1a,10,976,1b,17,993,28,N
2437,41,vid1b,10,993,1b,6,999,28,N
2438,41,vid2,10,999,2b,11,1010,28,N
2439,41,vid3,10,1010,3b,15,1025,28,N
2440,41,vid4,10,1026,4b,16,1042,28,N
2441,41,vid5,10,1042,5,7,1049,28,N
2442,41,vid1a_q,11,1075,1b,17,1092,2,S
2443,41,vid1b_q,11,1092,1b,6,1098,2,S
2444,41,vid2_q,11,1098,2b,11,1109,2,S
2445,41,vid3_q,11,1112,3a,15,1127,2,S
2446,41,vid4_q,11,1130,4b,16,1146,2,S
2447,41,vid5_q,11,1146,5,7,1153,2,S
2448,42,vid1a_q,0,13,1b,17,30,20,S
2449,42,vid1b_q,0,29,1b,6,35,20,S
2450,42,vid2_q,0,35,2a,11,46,20,S
2451,42,vid3_q,0,49,3b,15,64,20,S
2452,42,vid4_q,0,67,4a,16,83,20,S
2453,42,vid5_q,0,83,5,7,90,20,S
2454,42,vid1a,1,111,1b,17,128,28,N
2455,42,vid1b,1,128,1b,6,134,28,N
2456,42,vid2,1,134,2a,11,145,28,N
2457,42,vid3,1,145,3a,15,160,28,N
2458,42,vid4,1,161,4a,16,177,28,N
2459,42,vid5,1,177,5,7,184,28,N
2460,42,vid1a,2,207,1b,17,224,2,N
2461,42,vid1b,2,224,1b,6,230,2,N
2462,42,vid2,2,230,2b,11,241,2,N
2463,42,vid3,2,241,3b,15,256,2,N
2464,42,vid4,2,257,4b,16,273,2,N
2465,42,vid5,2,273,5,7,280,2,N
2466,42,vid1a,3,303,1b,17,320,34,S
2467,42,vid1b,3,320,1b,6,326,34,S
2468,42,vid2,3,326,2a,11,337,34,S
2469,42,vid3,3,337,3b,15,352,34,S
2470,42,vid4,3,353,4a,16,369,34,S
2471,42,vid5,3,369,5,7,376,34,S
2472,42,vid1a,4,399,1b,17,416,17,S
2473,42,vid1b,4,416,1b,6,422,17,S
2474,42,vid2,4,422,2a,11,433,17,S
2475,42,vid3,4,433,3b,15,448,17,S
2476,42,vid4,4,448,4a,16,464,17,S
2477,42,vid5,4,464,5,7,471,17,S
2478,42,vid1a,5,495,1b,17,512,1,N
2479,42,vid1b,5,512,1b,6,518,1,N
2480,42,vid2,5,518,2a,11,529,1,N
2481,42,vid3,5,529,3a,15,544,1,N
2482,42,vid4,5,545,4a,16,561,1,N
2483,42,vid5,5,561,5,7,568,1,N
2484,42,vid1a,6,591,1b,17,608,19,N
2485,42,vid1b,6,608,1b,6,614,19,N
2486,42,vid2,6,614,2b,11,625,19,N
2487,42,vid3,6,625,3b,15,640,19,N
2488,42,vid4,6,641,4b,16,657,19,N
2489,42,vid5,6,657,5,7,664,19,N
2490,42,vid1a,7,688,1b,17,705,23,S
2491,42,vid1b,7,705,1b,6,711,23,S
2492,42,vid2,7,711,2b,11,722,23,S
2493,42,vid3,7,722,3a,15,737,23,S
2494,42,vid4,7,737,4b,16,753,23,S
2495,42,vid5,7,753,5,7,760,23,S
2496,42,vid1a,8,784,1b,17,801,38,S
2497,42,vid1b,8,801,1b,6,807,38,S
2498,42,vid2,8,807,2b,11,818,38,S
2499,42,vid3,8,818,3a,15,833,38,S
2500,42,vid4,8,834,4b,16,850,38,S
2501,42,vid5,8,850,5,7,857,38,S
2502,42,vid1a,9,881,1b,17,898,6,N
2503,42,vid1b,9,898,1b,6,904,6,N
2504,42,vid2,9,904,2b,11,915,6,N
2505,42,vid3,9,915,3b,15,930,6,N
2506,42,vid4,9,930,4b,16,946,6,N
2507,42,vid5,9,946,5,7,953,6,N
2508,42,vid1a,10,977,1b,17,994,22,N
2509,42,vid1b,10,994,1b,6,1000,22,N
2510,42,vid2,10,1000,2a,11,1011,22,N
2511,42,vid3,10,1011,3a,15,1026,22,N
2512,42,vid4,10,1027,4a,16,1043,22,N
2513,42,vid5,10,1043,5,7,1050,22,N
2514,42,vid1a_q,11,1076,1b,17,1093,29,S
2515,42,vid1b_q,11,1092,1b,6,1098,29,S
2516,42,vid2_q,11,1098,2b,11,1109,29,S
2517,42,vid3_q,11,1112,3a,15,1127,29,S
2518,42,vid4_q,11,1130,4b,16,1146,29,S
2519,42,vid5_q,11,1146,5,7,1153,29,S
2520,43,vid1a_q,0,12,1b,17,29,2,S
2521,43,vid1b_q,0,29,1b,6,35,2,S
2522,43,vid2_q,0,35,2a,11,46,2,S
2523,43,vid3_q,0,49,3b,15,64,2,S
2524,43,vid4_q,0,67,4a,16,83,2,S
2525,43,vid5_q,0,83,5,7,90,2,S
2526,43,vid1a,1,111,1b,17,128,29,N
2527,43,vid1b,1,128,1b,6,134,29,N
2528,43,vid2,1,134,2b,11,145,29,N
2529,43,vid3,1,145,3b,15,160,29,N
2530,43,vid4,1,161,4b,16,177,29,N
2531,43,vid5,1,177,5,7,184,29,N
2532,43,vid1a,2,207,1b,17,224,19,N
2533,43,vid1b,2,224,1b,6,230,19,N
2534,43,vid2,2,230,2a,11,241,19,N
2535,43,vid3,2,241,3a,15,256,19,N
2536,43,vid4,2,256,4a,16,272,19,N
2537,43,vid5,2,272,5,7,279,19,N
2538,43,vid1a,3,303,1b,17,320,20,S
2539,43,vid1b,3,320,1b,6,326,20,S
2540,43,vid2,3,326,2b,11,337,20,S
2541,43,vid3,3,337,3a,15,352,20,S
2542,43,vid4,3,353,4b,16,369,20,S
2543,43,vid5,3,369,5,7,376,20,S
2544,43,vid1a,4,399,1b,17,416,34,S
2545,43,vid1b,4,415,1b,6,421,34,S
2546,43,vid2,4,421,2a,11,432,34,S
2547,43,vid3,4,433,3b,15,448,34,S
2548,43,vid4,4,448,4a,16,464,34,S
2549,43,vid5,4,464,5,7,471,34,S
2550,43,vid1a,5,495,1b,17,512,17,N
2551,43,vid1b,5,511,1b,6,517,17,N
2552,43,vid2,5,517,2a,11,528,17,N
2553,43,vid3,5,529,3a,15,544,17,N
2554,43,vid4,5,544,4a,16,560,17,N
2555,43,vid5,5,560,5,7,567,17,N
2556,43,vid1a,6,591,1b,17,608,38,N
2557,43,vid1b,6,607,1b,6,613,38,N
2558,43,vid2,6,613,2b,11,624,38,N
2559,43,vid3,6,625,3b,15,640,38,N
2560,43,vid4,6,640,4b,16,656,38,N
2561,43,vid5,6,656,5,7,663,38,N
2562,43,vid1a,7,687,1b,17,704,1,S
2563,43,vid1b,7,704,1b,6,710,1,S
2564,43,vid2,7,710,2a,11,721,1,S
2565,43,vid3,7,721,3b,15,736,1,S
2566,43,vid4,7,736,4a,16,752,1,S
2567,43,vid5,7,752,5,7,759,1,S
2568,43,vid1a,8,783,1b,17,800,28,S
2569,43,vid1b,8,800,1b,6,806,28,S
2570,43,vid2,8,806,2b,11,817,28,S
2571,43,vid3,8,817,3a,15,832,28,S
2572,43,vid4,8,833,4b,16,849,28,S
2573,43,vid5,8,849,5,7,856,28,S
2574,43,vid1a,9,880,1b,17,897,23,N
2575,43,vid1b,9,897,1b,6,903,23,N
2576,43,vid2,9,903,2a,11,914,23,N
2577,43,vid3,9,914,3a,15,929,23,N
2578,43,vid4,9,929,4a,16,945,23,N
2579,43,vid5,9,945,5,7,952,23,N
2580,43,vid1a,10,977,1b,17,994,6,N
2581,43,vid1b,10,993,1b,6,999,6,N
2582,43,vid2,10,999,2b,11,1010,6,N
2583,43,vid3,10,1011,3b,15,1026,6,N
2584,43,vid4,10,1026,4b,16,1042,6,N
2585,43,vid5,10,1042,5,7,1049,6,N
2586,43,vid1a_q,11,1075,1b,17,1092,22,S
2587,43,vid1b_q,11,1092,1b,6,1098,22,S
2588,43,vid2_q,11,1098,2b,11,1109,22,S
2589,43,vid3_q,11,1112,3a,15,1127,22,S
2590,43,vid4_q,11,1130,4b,16,1146,22,S
2591,43,vid5_q,11,1146,5,7,1153,22,S
2592,44,vid1a_q,0,12,1b,17,29,22,S
2593,44,vid1b_q,0,29,1b,6,35,22,S
2594,44,vid2_q,0,35,2a,11,46,22,S
2595,44,vid3_q,0,49,3b,15,64,22,S
2596,44,vid4_q,0,67,4a,16,83,22,S
2597,44,vid5_q,0,83,5,7,90,22,S
2598,44,vid1a,1,111,1b,17,128,20,N
2599,44,vid1b,1,128,1b,6,134,20,N
2600,44,vid2,1,134,2b,11,145,20,N
2601,44,vid3,1,145,3b,15,160,20,N
2602,44,vid4,1,161,4b,16,177,20,N
2603,44,vid5,1,177,5,7,184,20,N
2604,44,vid1a,2,207,1b,17,224,17,N
2605,44,vid1b,2,223,1b,6,229,17,N
2606,44,vid2,2,229,2b,11,240,17,N
2607,44,vid3,2,241,3b,15,256,17,N
2608,44,vid4,2,256,4b,16,272,17,N
2609,44,vid5,2,272,5,7,279,17,N
2610,44,vid1a,3,302,1b,17,319,28,S
2611,44,vid1b,3,319,1b,6,325,28,S
2612,44,vid2,3,325,2b,11,336,28,S
2613,44,vid3,3,336,3a,15,351,28,S
2614,44,vid4,3,352,4b,16,368,28,S
2615,44,vid5,3,368,5,7,375,28,S
2616,44,vid1a,4,398,1b,17,415,29,S
2617,44,vid1b,4,415,1b,6,421,29,S
2618,44,vid2,4,421,2b,11,432,29,S
2619,44,vid3,4,433,3a,15,448,29,S
2620,44,vid4,4,448,4b,16,464,29,S
2621,44,vid5,4,464,5,7,471,29,S
2622,44,vid1a,5,494,1b,17,511,23,N
2623,44,vid1b,5,511,1b,6,517,23,N
2624,44,vid2,5,517,2a,11,528,23,N
2625,44,vid3,5,528,3a,15,543,23,N
2626,44,vid4,5,544,4a,16,560,23,N
2627,44,vid5,5,560,5,7,567,23,N
2628,44,vid1a,6,591,1b,17,608,2,N
2629,44,vid1b,6,607,1b,6,613,2,N
2630,44,vid2,6,613,2a,11,624,2,N
2631,44,vid3,6,625,3a,15,640,2,N
2632,44,vid4,6,640,4a,16,656,2,N
2633,44,vid5,6,656,5,7,663,2,N
2634,44,vid1a,7,687,1b,17,704,6,S
2635,44,vid1b,7,704,1b,6,710,6,S
2636,44,vid2,7,710,2b,11,721,6,S
2637,44,vid3,7,721,3a,15,736,6,S
2638,44,vid4,7,736,4b,16,752,6,S
2639,44,vid5,7,752,5,7,759,6,S
2640,44,vid1a,8,783,1b,17,800,34,S
2641,44,vid1b,8,800,1b,6,806,34,S
2642,44,vid2,8,806,2a,11,817,34,S
2643,44,vid3,8,817,3b,15,832,34,S
2644,44,vid4,8,832,4a,16,848,34,S
2645,44,vid5,8,848,5,7,855,34,S
2646,44,vid1a,9,879,1b,17,896,1,N
2647,44,vid1b,9,896,1b,6,902,1,N
2648,44,vid2,9,902,2b,11,913,1,N
2649,44,vid3,9,913,3b,15,928,1,N
2650,44,vid4,9,929,4b,16,945,1,N
2651,44,vid5,9,945,5,7,952,1,N
2652,44,vid1a,10,976,1b,17,993,19,N
2653,44,vid1b,10,992,1b,6,998,19,N
2654,44,vid2,10,998,2a,11,1009,19,N
2655,44,vid3,10,1010,3a,15,1025,19,N
2656,44,vid4,10,1025,4a,16,1041,19,N
2657,44,vid5,10,1041,5,7,1048,19,N
2658,44,vid1a_q,11,1074,1b,17,1091,38,S
2659,44,vid1b_q,11,1091,1b,6,1097,38,S
2660,44,vid2_q,11,1097,2a,11,1108,38,S
2661,44,vid3_q,11,1111,3b,15,1126,38,S
2662,44,vid4_q,11,1129,4a,16,1145,38,S
2663,44,vid5_q,11,1145,5,7,1152,38,S
